title,studio,domestic_gross,foreign_gross,year,total_gross
toy story 3,BV,415000000,652000000,2010,1067000000
alice in wonderland (2010),BV,334200000,691300000,2010,1025500000
harry potter and the deathly hallows part 1,WB,296000000,664300000,2010,960300000
inception,WB,292600000,535700000,2010,828300000
shrek forever after,P/DW,238700000,513900000,2010,752600000
the twilight saga: eclipse,Sum.,300500000,398000000,2010,698500000
iron man 2,Par.,312400000,311500000,2010,623900000
tangled,BV,200800000,391000000,2010,591800000
despicable me,Uni.,251500000,291600000,2010,543100000
how to train your dragon,P/DW,217600000,277300000,2010,494900000
clash of the titans (2010),WB,163200000,330000000,2010,493200000
the chronicles of narnia: the voyage of the dawn treader,Fox,104400000,311300000,2010,415700000
the king's speech,Wein.,135500000,275400000,2010,410900000
tron legacy,BV,172100000,228000000,2010,400100000
the karate kid,Sony,176600000,182500000,2010,359100000
prince of persia: the sands of time,BV,90800000,245600000,2010,336400000
black swan,FoxS,107000000,222400000,2010,329400000
megamind,P/DW,148400000,173500000,2010,321900000
robin hood,Uni.,105300000,216400000,2010,321700000
the last airbender,Par.,131800000,187900000,2010,319700000
little fockers,Uni.,148400000,162200000,2010,310600000
resident evil: afterlife,SGem,60100000,240100000,2010,300200000
shutter island,Par.,128000000,166800000,2010,294800000
salt,Sony,118300000,175200000,2010,293500000
sex and the city 2,WB (NL),95300000,193000000,2010,288300000
the tourist,Sony,67600000,210700000,2010,278300000
the expendables,LGF,103100000,171400000,2010,274500000
grown ups,Sony,162000000,109400000,2010,271400000
knight & day,Fox,76400000,185500000,2010,261900000
true grit,Par.,171200000,81000000,2010,252200000
gulliver's travels,Fox,42800000,194600000,2010,237400000
percy jackson & the olympians: the lightning thief,Fox,88800000,137700000,2010,226500000
the social network,Sony,97000000,128000000,2010,225000000
valentine's day,WB (NL),110500000,106000000,2010,216500000
the sorcerer's apprentice,BV,63200000,152100000,2010,215300000
due date,WB,100500000,111200000,2010,211700000
eat pray love,Sony,80600000,124000000,2010,204600000
yogi bear,WB,100200000,101300000,2010,201500000
red,Sum.,90400000,108600000,2010,199000000
paranormal activity 2,Par.,84800000,92800000,2010,177600000
the a-team,Fox,77200000,100000000,2010,177200000
jackass 3-d,Par.,117200000,54500000,2010,171700000
the other guys,Sony,119200000,51200000,2010,170400000
unstoppable,Fox,81600000,86200000,2010,167800000
step up 3-d,BV,42400000,116900000,2010,159300000
the book of eli,WB,94800000,62300000,2010,157100000
the town,WB,92200000,61800000,2010,154000000
date night,Fox,98700000,53600000,2010,152300000
legend of the guardians: the owls of ga'hoole,WB,55700000,84400000,2010,140100000
the wolfman,Uni.,62000000,77800000,2010,139800000
the bounty hunter,Sony,67099999,69300000,2010,136399999
saw 3d,LGF,45700000,90400000,2010,136100000
wall street: money never sleeps,Fox,52500000,82300000,2010,134800000
the fighter,Par.,93600000,35600000,2010,129200000
predators,Fox,52000000,75200000,2010,127200000
a nightmare on elm street (2010),WB (NL),63100000,52600000,2010,115700000
dear john,SGem,80000000,35000000,2010,115000000
cats & dogs: the revenge of kitty galore,WB,43600000,68900000,2010,112500000
tooth fairy,Fox,60000000,52400000,2010,112400000
life as we know it,WB,53400000,52300000,2010,105700000
hereafter,WB,32700000,72500000,2010,105200000
the girl with the dragon tattoo,MBox,10100000,94300000,2010,104400000
love and other drugs,Fox,32400000,70500000,2010,102900000
aftershock (tangshan dadizhen),CL,63000,100200000,2010,100263000
killers,LGF,47100000,51100000,2010,98200000
kick-ass,LGF,48100000,48100000,2010,96200000
green zone,Uni.,35100000,59800000,2010,94900000
nanny mcphee returns,Uni.,29000000,64200000,2010,93200000
get him to the greek,Uni.,61000000,30300000,2010,91300000
burlesque,SGem,39400000,50100000,2010,89500000
the last song,BV,63000000,26100000,2010,89100000
dinner for schmucks,P/DW,73000000,13800000,2010,86800000
marmaduke,Fox,33600000,50100000,2010,83700000
piranha 3d,W/Dim.,25000000,58200000,2010,83200000
oceans,BV,19400000,63200000,2010,82600000
edge of darkness,WB,43300000,37800000,2010,81100000
vampires suck,Fox,36700000,43900000,2010,80600000
letters to juliet,Sum.,53000000,26100000,2010,79100000
the back-up plan,CBS,37500000,40000000,2010,77500000
if you are the one 2 (fei cheng wu rao ii),CL,427000,75600000,2010,76027000
diary of a wimpy kid,Fox,64000000,11700000,2010,75700000
easy a,SGem,58400000,16600000,2010,75000000
hubble 3d,WB,52400000,21500000,2010,73900000
takers,SGem,57700000,11300000,2010,69000000
tales from earthsea,BV,48500,68600000,2010,68648500
legion (2010),SGem,40200000,27800000,2010,68000000
the american,Focus,35600000,32299999,2010,67899999
the last exorcism,LGF,41000000,26700000,2010,67700000
the next three days,LGF,21100000,46300000,2010,67400000
the girl who played with fire,MBox,7600000,59500000,2010,67100000
skyline,Uni.,21400000,45400000,2010,66800000
hot tub time machine,MGM,50300000,14300000,2010,64600000
devil,Uni.,33600000,29100000,2010,62700000
127 hours,FoxS,18300000,42400000,2010,60700000
tyler perry's why did i get married too?,LGF,60100000,578000,2010,60678000
secretariat,BV,59700000,537000,2010,60237000
the ghost writer,Sum.,15500000,44700000,2010,60200000
morning glory,Par.,31000000,29000000,2010,60000000
remember me,Sum.,19100000,37000000,2010,56100000
cop out,WB,44900000,10700000,2010,55600000
the crazies,Over.,39100000,15700000,2010,54800000
from paris with love,LGF,24100000,28700000,2010,52800000
daybreakers,LGF,30100000,21300000,2010,51400000
alpha and omega,LGF,25100000,25400000,2010,50500000
the switch,Mira.,27800000,22100000,2010,49900000
she's out of my league,Par.,32000000,17800000,2010,49800000
death at a funeral (2010),SGem,42700000,6300000,2010,49000000
how do you know,Sony,30200000,18500000,2010,48700000
charlie st. cloud,Uni.,31200000,17000000,2010,48200000
scott pilgrim vs. the world,Uni.,31500000,16100000,2010,47600000
heartbreaker,IFC,504000,46900000,2010,47404000
the spy next door,LGF,24300000,20900000,2010,45200000
"the good, the bad, the weird",IFC,128000,44100000,2010,44228000
machete,Fox,26600000,17500000,2010,44100000
the girl who kicked the hornet's nest,MBox,5200000,38300000,2010,43500000
the man from nowhere,CJ,528000,42500000,2010,43028000
when in rome,BV,32700000,10400000,2010,43100000
my name is khan,FoxS,4000000,38300000,2010,42300000
going the distance,WB (NL),17800000,24200000,2010,42000000
the concert,Wein.,658000,40500000,2010,41158000
agora,NM,619000,38400000,2010,39019000
for colored girls,LGF,37700000,17300,2010,37717300
brooklyn's finest,Over.,27200000,9300000,2010,36500000
furry vengeance,Sum.,17600000,18600000,2010,36200000
faster,CBS,23200000,12400000,2010,35600000
the kids are all right,Focus,20800000,13900000,2010,34700000
you will meet a tall dark stranger,SPC,3200000,31000000,2010,34200000
the secret in their eyes,SPC,6400000,27600000,2010,34000000
avatar: special edition,Fox,10700000,22500000,2010,33200000
leap year,Uni.,25900000,6700000,2010,32600000
you again,BV,25700000,6300000,2010,32000000
mesrine: killer instinct,MBox,552000,30500000,2010,31052000
the losers,WB,23600000,5800000,2010,29400000
case 39,ParV,13300000,14900000,2010,28200000
ramona and beezus,Fox,26200000,1100000,2010,27300000
splice,WB,17000000,9800000,2010,26800000
fair game (2010),Sum.,9500000,14600000,2010,24100000
let me in,Over.,12100000,12000000,2010,24100000
mao's last dancer,Gold.,4800000,17500000,2010,22300000
just wright,FoxS,21500000,29900,2010,21529900
our family wedding,FoxS,20300000,1200000,2010,21500000
my soul to take,Uni.,14700000,6200000,2010,20900000
71 into the fire,JS,177000,20800000,2010,20977000
"i love you, phillip morris",RAtt.,2000000,18700000,2010,20700000
country strong,SGem,20200000,310000,2010,20510000
another year,SPC,3200000,16500000,2010,19700000
youth in revolt,W/Dim.,15300000,4400000,2010,19700000
buried,LGF,1000000,18100000,2010,19100000
[rec] 2,Magn.,27800,18500000,2010,18527800
repo men,Uni.,13800000,4600000,2010,18400000
a prophet (un proph√®te),SPC,2100000,15800000,2010,17900000
soul kitchen,IFC,277000,17600000,2010,17877000
mother (2010),Magn.,552000,16600000,2010,17152000
micmacs,SPC,1300000,15100000,2010,16400000
the nutcracker in 3d,Free,195000,16000000,2010,16195000
sea rex 3d: journey to a prehistoric world,3D,6100000,9900000,2010,16000000
i hate luv storys,UTV,848000,14900000,2010,15748000
extraordinary measures,CBS,12100000,3100000,2010,15200000
somewhere,Focus,1800000,12200000,2010,14000000
winter's bone,RAtt.,6500000,7300000,2010,13800000
the last station,SPC,6600000,6900000,2010,13500000
raajneeti,UTV,1500000,11100000,2010,12600000
made in dagenham,SPC,1100000,11300000,2010,12400000
blue valentine,Wein.,9700000,2600000,2010,12300000
tamara drewe,SPC,560000,11400000,2010,11960000
chloe,SPC,3100000,8600000,2010,11700000
looking for eric,IFC,55800,11500000,2010,11555800
the warrior's way,Rela.,5700000,5400000,2010,11100000
i am love,Magn.,5000000,5900000,2010,10900000
jonah hex,WB,10500000,356000,2010,10856000
harry brown,Gold.,1800000,8500000,2010,10300000
cyrus,FoxS,7500000,2500000,2010,10000000
conviction,FoxS,6800000,2900000,2010,9700000
get low,SPC,9200000,518000,2010,9718000
babies,Focus,7300000,2200000,2010,9500000
stone,Over.,1800000,7700000,2010,9500000
peepli live,UTV,758000,8700000,2010,9458000
never let me go,FoxS,2400000,7000000,2010,9400000
mid-august lunch,Zeit.,675000,8700000,2010,9375000
macgruber,Uni.,8500000,797000,2010,9297000
city island,Anch.,6700000,1200000,2010,7900000
inside job,SPC,4300000,3600000,2010,7900000
the joneses,RAtt.,1500000,5500000,2010,7000000
centurion,Magn.,124000,6700000,2010,6824000
animal kingdom,SPC,1000000,5700000,2010,6700000
nowhere boy,Wein.,1500000,5100000,2010,6600000
it's kind of a funny story,Focus,6400000,128000,2010,6528000
"waiting for ""superman""",ParV,6400000,9300,2010,6409300
greenberg,Focus,4200000,1900000,2010,6100000
coco chanel & igor stravinsky,SPC,1600000,4099999,2010,5699999
vincere,IFC,619000,5100000,2010,5719000
the illusionist (2010),SPC,2200000,3400000,2010,5600000
exit through the gift shop,PDA,3300000,2000000,2010,5300000
mademoiselle chambon,Lorb.,532000,4700000,2010,5232000
solitary man,Anch.,4400000,818000,2010,5218000
rabbit hole,LGF,2200000,2900000,2010,5100000
vision,Zeit.,435000,4600000,2010,5035000
mother and child,SPC,1100000,3900000,2010,5000000
the runaways,App.,3600000,1100000,2010,4700000
four lions,Drft.,305000,4400000,2010,4705000
wild grass,SPC,404000,4200000,2010,4604000
please give,SPC,4000000,280000,2010,4280000
monsters,Magn.,237000,4000000,2010,4237000
rare exports: a christmas tale,Osci.,236000,3800000,2010,4036000
the killer inside me,IFC,217000,3800000,2010,4017000
the perfect game,IW,1000000,2800000,2010,3800000
to save a life,Gold.,3800000,45800,2010,3845800
inspector bellamy,IFC,108000,3600000,2010,3708000
catfish,Rog.,3200000,242000,2010,3442000
wild target,Free,109000,3300000,2010,3409000
frozen (2010),Anch.,246000,2900000,2010,3146000
dabangg,Eros,1300000,1700000,2010,3000000
kites,Relbig.,1600000,1300000,2010,2900000
letters to god,Viv.,2800000,60300,2010,2860300
twelve,Hann.,184000,2400000,2010,2584000
tees maar khan,UTV,1100000,1400000,2010,2500000
fish tank,IFC,375000,2000000,2010,2375000
housefull,Eros,1200000,1200000,2010,2400000
golmaal 3,Eros,1100000,935000,2010,2035000
after.life,Anch.,109000,1900000,2010,2009000
cairo time,IFC,1600000,391000,2010,1991000
flipped,WB,1800000,0,2010,1800000
guzaarish,UTV,1000000,695000,2010,1695000
ondine,Magn.,550000,1100000,2010,1650000
anjaana anjaani,Eros,855000,761000,2010,1616000
john rabe,Strand,67500,1400000,2010,1467500
restrepo,NGE,1300000,105000,2010,1405000
raavan,Relbig.,709000,648000,2010,1357000
the city of your final destination,Scre.,493000,859000,2010,1352000
it's a wonderful afterlife,UTV,0,1300000,2010,1300000
ajami,Kino,622000,669000,2010,1291000
army of crime,Lorb.,37000,1200000,2010,1237000
lebanon,SPC,368000,830000,2010,1198000
howl,Osci.,617000,566000,2010,1183000
videocracy,Kino,23700,1200000,2010,1223700
when you're strange,Abr.,246000,901000,2010,1147000
the salvation poem (poema de salvacion),CZ,915000,183000,2010,1098000
casino jack,ATO,1000000,40700,2010,1040700
leaving,IFC,176000,893000,2010,1069000
khatta meetha,Eros,542000,499000,2010,1041000
we are family,UTV,638000,393000,2010,1031000
leaves of grass,First,70100,949000,2010,1019100
north face,MBox,711000,216000,2010,927000
creation,NM,341000,555000,2010,896000
no one knows about persian cats,IFC,81800,798000,2010,879800
carlos,IFC,146000,726000,2010,872000
hideaway (le refuge),Strand,34500,837000,2010,871500
the disappearance of alice creed,Anch.,167000,701000,2010,868000
break ke baad,Relbig.,428000,389000,2010,817000
veer (2010),Eros,527000,277000,2010,804000
life during wartime,IFC,281000,487000,2010,768000
enter the void,IFC,336000,418000,2010,754000
the secret of kells,GK,677000,62700,2010,739700
the polar express (imax re-issue 2010),WB,673000,0,2010,673000
no problem,Eros,285000,369000,2010,654000
all good things,Magn.,582000,62500,2010,644500
jack goes boating,Over.,542000,77600,2010,619600
holy rollers,FInd.,303000,305000,2010,608000
chain letter,NFC,139000,447000,2010,586000
i spit on your grave,Anch.,93100,480000,2010,573100
i'm still here,Magn.,409000,160000,2010,569000
salt of this sea,Lorb.,11700,545000,2010,556700
undertow (2010),TFC,109000,393000,2010,502000
father of my children,IFC,144000,335000,2010,479000
the greatest (2010),Pala.,115000,359000,2010,474000
the extra man,Magn.,453000,4500,2010,457500
tiny furniture,IFC,392000,0,2010,392000
dogtooth,Kino,110000,274000,2010,384000
grease (sing-a-long re-issue),Par.,366000,0,2010,366000
the tempest,Mira.,278000,68700,2010,346700
the good heart,Magn.,20900,323000,2010,343900
formosa betrayed,Scre.,225000,101000,2010,326000
red hill,Strand,21100,300000,2010,321100
welcome to the rileys,Gold.,159000,158000,2010,317000
"a woman, a gun and a noodle shop",SPC,191000,121000,2010,312000
the girl on the train,Strand,208000,97100,2010,305100
mesrine: public enemy no. 1,MBox,275000,28100,2010,303100
44 inch chest,Imag.,39000,255000,2010,294000
karthik calling karthik,Eros,286000,7100,2010,293100
last train home,Zeit.,288000,0,2010,288000
eyes wide open,NAV,26300,250000,2010,276300
waste land,Arth.,188000,88700,2010,276700
south of the border,CLS,199000,70800,2010,269800
human centipede,IFC,181000,70700,2010,251700
"lovely, still",Mont.,128000,106000,2010,234000
the girl (flickan),Olive,2200,229000,2010,231200
sweetgrass,CGld,207000,0,2010,207000
bitch slap,Free,17400,182000,2010,199400
chance pe dance,UTV,169000,24300,2010,193300
client 9: the rise and fall of eliot spitzer,Magn.,189000,3500,2010,192500
casino jack and the united states of money,Magn.,177000,0,2010,177000
perrier's bounty,IFC,800,167000,2010,167800
around a small mountain,CGld,33200,131000,2010,164200
spring fever,Strand,10800,150000,2010,160800
the eclipse,Magn.,133000,26400,2010,159400
george a. romero's survival of the dead,Magn.,102000,41500,2010,143500
the romantics,FOAK,107000,17300,2010,124300
celine: through the eyes of the world,Sony,0,119000,2010,119000
freakonomics,Magn.,101000,16400,2010,117400
saint john of las vegas,IVP,103000,9100,2010,112100
band baaja baaraat,Yash,43800,60700,2010,104500
white lion,Scre.,0,99600,2010,99600
kisses,Osci.,81700,15300,2010,97000
waking sleeping beauty,BV,80700,4200,2010,84900
enemies of the people,ICir,73200,6400,2010,79600
badmaash company,Yash,0,64400,2010,64400
hadewijch,IFC,5000,57500,2010,62500
alamar,FM,61600,0,2010,61600
as good as dead,First,2000,53600,2010,55600
inhale,IFC,4100,51000,2010,55100
hatchet 2,Vita.,52600,0,2010,52600
district b13: ultimatum,Magn.,36100,16200,2010,52300
gasland,WOW,30800,18600,2010,49400
boogie woogie,IFC,2600,44900,2010,47500
come undone (2010),FM,10000,31300,2010,41300
the red baron,Mont.,37200,3100,2010,40300
bluebeard,Strand,33500,5200,2010,38700
daddy longlegs,IFC,21800,11500,2010,33300
living in emergency,Truly,32200,0,2010,32200
nenette,Kino,18000,5400,2010,23400
picture me,Strand,12000,10400,2010,22400
the thorn in the heart,Osci.,7400,10500,2010,17900
the taqwacores,Strand,11400,0,2010,11400
cherry,Abr.,11400,0,2010,11400
terkel in trouble,Indic.,10800,0,2010,10800
kimjongilia,Lorb.,4400,0,2010,4400
aashayein (wishes),Relbig.,0,3800,2010,3800
harry potter and the deathly hallows part 2,WB,381000000,960500000,2011,1341500000
transformers: dark of the moon,P/DW,352400000,771400000,2011,1123800000
pirates of the caribbean: on stranger tides,BV,241100000,804600000,2011,1045700000
the twilight saga: breaking dawn part 1,Sum.,281300000,430900000,2011,712200000
mission: impossible - ghost protocol,Par.,209400000,485300000,2011,694700000
kung fu panda 2,P/DW,165200000,500400000,2011,665600000
fast five,Uni.,209800000,416300000,2011,626100000
the hangover part ii,WB,254500000,332300000,2011,586800000
the smurfs,Sony,142600000,421100000,2011,563700000
cars 2,BV,191500000,370700000,2011,562200000
puss in boots,P/DW,149300000,405700000,2011,555000000
sherlock holmes: a game of shadows,WB,186800000,358600000,2011,545400000
rio,Fox,143600000,341000000,2011,484600000
rise of the planet of the apes,Fox,176800000,305000000,2011,481800000
thor,Par.,181000000,268300000,2011,449300000
the adventures of tintin,Par.,77600000,296400000,2011,374000000
captain america: the first avenger,Par.,176700000,193900000,2011,370600000
x-men: first class,Fox,146400000,207200000,2011,353600000
alvin and the chipmunks: chipwrecked,Fox,133100000,209600000,2011,342700000
real steel,BV,85500000,213800000,2011,299300000
bridesmaids,Uni.,169100000,119300000,2011,288400000
super 8,Par.,127000000,133100000,2011,260100000
rango,Par.,123500000,122200000,2011,245700000
the girl with the dragon tattoo (2011),Sony,102500000,130100000,2011,232600000
the green hornet,Sony,98800000,129000000,2011,227800000
immortals,Rela.,83500000,143400000,2011,226900000
green lantern,WB,116600000,103300000,2011,219900000
the help,BV,169700000,46900000,2011,216600000
bad teacher,Sony,100300000,115900000,2011,216200000
just go with it,Sony,103000000,111900000,2011,214900000
battle: los angeles,Sony,83600000,128300000,2011,211900000
horrible bosses,WB (NL),117500000,92100000,2011,209600000
paranormal activity 3,Par.,104000000,103000000,2011,207000000
gnomeo and juliet,BV,100000000,94000000,2011,194000000
mr. popper's penguins,Fox,68200000,119100000,2011,187300000
hugo,Par.,73900000,111900000,2011,185800000
the lion king (in 3d),BV,94200000,91300000,2011,185500000
hop,Uni.,108100000,75900000,2011,184000000
war horse,BV,79900000,97700000,2011,177600000
the descendants,FoxS,82600000,94700000,2011,177300000
cowboys & aliens,Uni.,100200000,74600000,2011,174800000
in time,Fox,37500000,136400000,2011,173900000
zookeeper,Sony,80400000,89500000,2011,169900000
the muppets,BV,88600000,76600000,2011,165200000
limitless,Rela.,79200000,82600000,2011,161800000
johnny english reborn,Uni.,8300000,151800000,2011,160100000
final destination 5,WB (NL),42600000,115300000,2011,157900000
tower heist,Uni.,78000000,74900000,2011,152900000
midnight in paris,SPC,56800000,94300000,2011,151100000
happy feet two,WB,64000000,86400000,2011,150400000
i am number four,BV,55100000,94800000,2011,149900000
jack and jill,Sony,74200000,75500000,2011,149700000
friends with benefits,SGem,55800000,93700000,2011,149500000
no strings attached,Par.,70700000,78600000,2011,149300000
arthur christmas,Sony,46500000,101000000,2011,147500000
source code,Sum.,54700000,92600000,2011,147300000
"crazy, stupid, love.",WB,84400000,58500000,2011,142900000
new year's eve,WB (NL),54500000,87500000,2011,142000000
contagion,WB,75700000,59800000,2011,135500000
the artist,Wein.,44700000,88800000,2011,133500000
the three musketeers (2011),Sum.,20400000,111900000,2011,132300000
unknown,WB,63700000,67099999,2011,130799999
the adjustment bureau,Uni.,62500000,65400000,2011,127900000
we bought a zoo,Fox,75600000,44500000,2011,120100000
water for elephants,Fox,58700000,58400000,2011,117100000
the iron lady,Wein.,30000000,84900000,2011,114900000
moneyball,Sony,75600000,34600000,2011,110200000
sanctum,Uni.,23200000,85400000,2011,108600000
justin bieber: never say never,Par.,73000000,26000000,2011,99000000
paul,Uni.,37400000,60600000,2011,98000000
scream 4,W/Dim.,38200000,59000000,2011,97200000
insidious,FD,54000000,43000000,2011,97000000
the rite,WB (NL),33000000,63000000,2011,96000000
dolphin tale,WB,72300000,23100000,2011,95400000
season of the witch,Rela.,24800000,66800000,2011,91600000
sucker punch,WB,36400000,53400000,2011,89800000
red riding hood,WB,37700000,51500000,2011,89200000
spy kids: all the time in the world,W/Dim.,38500000,47000000,2011,85500000
j. edgar,WB,37300000,47600000,2011,84900000
hall pass,WB (NL),45100000,38100000,2011,83200000
"big mommas: like father, like son",Fox,37900000,44800000,2011,82700000
abduction,LGF,28100000,54000000,2011,82100000
"tinker, tailor, soldier, spy",Focus,24100000,56500000,2011,80600000
priest,SGem,29100000,49200000,2011,78300000
drive (2011),FD,35100000,41100000,2011,76200000
the mechanic,CBS,29100000,47000000,2011,76100000
the ides of march,Sony,41000000,35000000,2011,76000000
the change-up,Uni.,37100000,38400000,2011,75500000
the lincoln lawyer,LGF,58000000,17000000,2011,75000000
diary of a wimpy kid: rodrick rules,Fox,52700000,19700000,2011,72400000
larry crowne,Uni.,35600000,36400000,2011,72000000
the dilemma,Uni.,48500000,21200000,2011,69700000
the darkest hour,Sum.,21400000,43200000,2011,64600000
hanna,Focus,40300000,23500000,2011,63800000
footloose (2011),Par.,51800000,11700000,2011,63500000
elite squad: the enemy within,Vari.,100000,62900000,2011,63000000
colombiana,TriS,36700000,24300000,2011,61000000
something borrowed,WB,39000000,21100000,2011,60100000
one day,Focus,13800000,45500000,2011,59300000
beginning of the great revival,CL,151000,58200000,2011,58351000
killer elite,ORF,25100000,31300000,2011,56400000
extremely loud & incredibly close,WB,31800000,23400000,2011,55200000
the tree of life,FoxS,13300000,41000000,2011,54300000
tyler perry's madea's big happy family,LGF,53300000,816000,2011,54116000
detective dee and the mystery of the phantom flame,IM,460000,51300000,2011,51760000
winnie the pooh,BV,26700000,23200000,2011,49900000
conan the barbarian (2011),LGF,21300000,27500000,2011,48800000
soul surfer,TriS,43900000,3200000,2011,47100000
war of the arrows,CJ,251000,45800000,2011,46051000
arthur (2011),WB,33000000,12700000,2011,45700000
the debt,Focus,31200000,14500000,2011,45700000
beastly,CBS,27900000,15300000,2011,43200000
of gods and men,SPC,4000000,38200000,2011,42200000
born to be wild (imax),WB,25900000,15600000,2011,41500000
evangelion 2.0: you can (not) advance,Elev.,134000,41000000,2011,41134000
fright night (2011),BV,18300000,22700000,2011,41000000
30 minutes or less,Sony,37100000,3500000,2011,40600000
the roommate,SGem,37300000,3200000,2011,40500000
shark night 3d,Rela.,18900000,21300000,2011,40200000
monte carlo,Fox,23200000,16500000,2011,39700000
50/50,Sum.,35000000,4200000,2011,39200000
mars needs moms,BV,21400000,17600000,2011,39000000
dream house,Uni.,21300000,17200000,2011,38500000
jumping the broom,TriS,37300000,415000,2011,37715000
don't be afraid of the dark,FD,24000000,12900000,2011,36900000
ra one,Eros,2500000,33400000,2011,35900000
a very harold & kumar 3d christmas,WB,35100000,326000,2011,35426000
my week with marilyn,Wein.,14600000,20500000,2011,35100000
the sitter,Fox,30400000,4500000,2011,34900000
jane eyre,Focus,11200000,23500000,2011,34700000
courageous,TriS,34500000,0,2011,34500000
shaolin,Vari.,66100,33600000,2011,33666100
african cats,BV,15400000,15400000,2011,30800000
the skin i live in,SPC,3200000,27700000,2011,30900000
i don't know how she does it,Wein.,9700000,20900000,2011,30600000
what's your number?,Fox,14000000,16399999,2011,30399999
drive angry,Sum.,10700000,18200000,2011,28900000
carnage (2011),SPC,2500000,25100000,2011,27600000
a dangerous method,SPC,5700000,21800000,2011,27500000
the thing (2011),Uni.,16900000,10500000,2011,27400000
the eagle,Focus,19500000,7600000,2011,27100000
legend of the fist: the return of chen zhen,Vari.,50400,26500000,2011,26550400
apollo 18,W/Dim.,17700000,7900000,2011,25600000
biutiful,RAtt.,5100000,20000000,2011,25100000
your highness,Uni.,21600000,3300000,2011,24900000
our idiot brother,Wein.,24800000,0,2011,24800000
the rum diary,FD,13100000,10800000,2011,23900000
the women on the 6th floor,Strand,720000,22500000,2011,23220000
potiche,MBox,1600000,21600000,2011,23200000
warrior,LGF,13700000,9400000,2011,23100000
young adult,Par.,16300000,6600000,2011,22900000
sarah's key,Wein.,7700000,13400000,2011,21100000
the way back,NM,2700000,17600000,2011,20300000
a separation,SPC,7100000,12800000,2011,19900000
the guard,SPC,5400000,14200000,2011,19600000
margin call,RAtt.,5400000,14200000,2011,19600000
glee the 3d concert movie,Fox,11900000,6800000,2011,18700000
shame,FoxS,3900000,13800000,2011,17700000
13 assassins,Magn.,803000,16800000,2011,17603000
hoodwinked too! hood vs. evil,Wein.,10100000,6800000,2011,16900000
the heir apparent: largo winch,MBox,10400,16900000,2011,16910400
the last godfather,RAtt.,164000,16600000,2011,16764000
delhi belly,UTV,1500000,15200000,2011,16700000
melancholia,Magn.,3000000,12900000,2011,15900000
judy moody and the not bummer summer,Rela.,15000000,678000,2011,15678000
the conspirator,RAtt.,11500000,3900000,2011,15400000
anonymous,Sony,4500000,10900000,2011,15400000
ip man 2: legend of the grandmaster,Vari.,206000,14900000,2011,15106000
the housemaid,IFC,158000,14600000,2011,14758000
desert flower,NGE,44300,14600000,2011,14644300
pina,IFC,3500000,11100000,2011,14600000
beginners,Focus,5800000,8500000,2011,14300000
my afternoons with margueritte,Cohen,667000,13600000,2011,14267000
i saw the devil,Magn.,129000,12600000,2011,12729000
the hedgehog,NeoC,708000,12000000,2011,12708000
gainsbourg: a heroic life,MBox,233000,12000000,2011,12233000
the warring states,CL,69000,11800000,2011,11869000
what women want (wo zhi nu run xin),CL,124000,11700000,2011,11824000
snow flower and the secret fan,FoxS,1300000,10000000,2011,11300000
win win,FoxS,10200000,652000,2011,10852000
flying monsters,NGE,5700000,5100000,2011,10800000
city of life and death,Kino,123000,10600000,2011,10723000
le havre,Jan.,612000,9900000,2011,10512000
straw dogs (2011),SGem,10300000,0,2011,10300000
prom,BV,10100000,0,2011,10100000
in a better world,SPC,1000000,8600000,2011,9600000
trespass (2011),MNE,24100,9600000,2011,9624100
saving private perez,LGF,1400000,7900000,2011,9300000
point blank,Magn.,708000,8500000,2011,9208000
winter in wartime,SPC,543000,8700000,2011,9243000
barney's version (u.s. only),SPC,4400000,4000000,2011,8400000
outrage (2011),Magn.,44700,8400000,2011,8444700
senna,PDA,1600000,6600000,2011,8200000
last night,Trib.,99000,7600000,2011,7699000
the big year,Fox,7200000,244000,2011,7444000
the beaver,Sum.,971000,6300000,2011,7271000
take me home tonight,Rela.,6900000,0,2011,6900000
cedar rapids,FoxS,6900000,0,2011,6900000
the princess of montpensier,IFC,352000,6400000,2011,6752000
cave of forgotten dreams,IFC,5300000,1200000,2011,6500000
sex and zen 3d: extreme ecstasy,CL,153000,6200000,2011,6353000
we need to talk about kevin,Osci.,1700000,4300000,2011,6000000
attack the block,SGem,1000000,4800000,2011,5800000
even the rain,Vita.,518000,5300000,2011,5818000
young goethe in love,MBox,162000,5600000,2011,5762000
11-11-11,Rocket,32800,5700000,2011,5732800
certified copy,IFC,1400000,4099999,2011,5499999
thank you (2011),UTV,464000,5000000,2011,5464000
the company men,Wein.,4400000,441000,2011,4841000
force,FoxS,0,4800000,2011,4800000
tucker & dale vs. evil,Magn.,224000,4500000,2011,4724000
london boulevard,IFC,16100,4600000,2011,4616100
dylan dog: dead of night,OMNI/FSR,1200000,3400000,2011,4600000
the names of love,MBox,514000,4099999,2011,4613999
the way,PDA,4400000,0,2011,4400000
burke and hare,IFC,4800,4300000,2011,4304800
king of devil's island,FM,7600,4200000,2011,4207600
bride flight,MBox,501000,3700000,2011,4201000
trollhunter,Magn.,253000,3900000,2011,4153000
buck,IFC,4000000,0,2011,4000000
carancho,Strand,85500,3900000,2011,3985500
like crazy,ParV,3400000,336000,2011,3736000
the double,Imag.,138000,3600000,2011,3738000
don 2,Relbig.,3700000,0,2011,3700000
love crime,IFC,540000,3100000,2011,3640000
incendies (u.s. only),SPC,2100000,1500000,2011,3600000
martha marcy may marlene,FoxS,3000000,548000,2011,3548000
the king's speech (pg-13),Wein.,3300000,0,2011,3300000
machine gun preacher,Rela.,539000,2800000,2011,3339000
the last circus,Magn.,40500,3200000,2011,3240500
from prada to nada,LGF,3000000,123000,2011,3123000
flypaper,IFC,5000,3100000,2011,3105000
zindagi na milegi dobara,Eros,3100000,0,2011,3100000
take shelter,SPC,1700000,1400000,2011,3100000
the greatest miracle,KKM,555000,2500000,2011,3055000
rapt,Lorb.,45800,2900000,2011,2945800
pastorela,LGF,161000,2700000,2011,2861000
the double hour,Gold.,1500000,1200000,2011,2700000
everything must go,RAtt.,2700000,0,2011,2700000
3 (2011),Strand,60000,2600000,2011,2660000
oranges and sunshine,Cohen,143000,2400000,2011,2543000
ong bak 3,Magn.,14900,2300000,2011,2314900
poetry,Kino,356000,1900000,2011,2256000
the tree,Zeit.,71200,2100000,2011,2171200
"the butcher, the chef and the swordsman",CL,47900,2000000,2011,2047900
the trip (2011),IFC,2000000,0,2011,2000000
armadillo,Lorb.,14600,2000000,2011,2014600
bodyguard,Relbig.,1800000,0,2011,1800000
brighton rock,IFC,230000,1600000,2011,1830000
a somewhat gentle man,Strand,37700,1800000,2011,1837700
the topp twins: untouchable girls,Argo.,29300,1800000,2011,1829300
another earth,FoxS,1300000,456000,2011,1756000
a better life,Sum.,1800000,0,2011,1800000
chalet girl,IFC,1700,1700000,2011,1701700
yamla pagla deewana,Eros,993000,600000,2011,1593000
bill cunningham new york,Zeit.,1500000,0,2011,1500000
the art of getting by,FoxS,1400000,0,2011,1400000
the devil's double,LGF,1400000,0,2011,1400000
uncle boonmee who can recall his past lives,Strand,184000,946000,2011,1130000
the whistleblower,Gold.,1100000,0,2011,1100000
red state,SMod,1100000,0,2011,1100000
london river,Libre,7200,1100000,2011,1107200
desi boyz,Eros,1100000,0,2011,1100000
when we leave (die fremde),Olive,19600,1100000,2011,1119600
there be dragons,Gold.,1100000,0,2011,1100000
vanishing on 7th street,Magn.,22700,1000000,2011,1022700
page one: a year inside the new york times,Magn.,1100000,0,2011,1100000
the time that remains,IFC,32900,1000000,2011,1032900
rockstar (2011),Eros,987000,0,2011,987000
meek's cutoff,Osci.,978000,0,2011,978000
texas killing fields,Anch.,45500,912000,2011,957500
ready,Eros,955000,0,2011,955000
miral,Wein.,373000,527000,2011,900000
submarine,Wein.,468000,397000,2011,865000
higher ground,SPC,842000,0,2011,842000
mozart's sister,MBox,708000,132000,2011,840000
plastic planet,FRun,3200,836000,2011,839200
chillar party,UTV,6300,826000,2011,832300
mausam,Eros,728000,0,2011,728000
the first grader,NGE,332000,382000,2011,714000
hobo with a shotgun,Magn.,703000,0,2011,703000
tabloid,IFC,697000,0,2011,697000
dhobi ghat (mumbai diaries),UTV,577000,102000,2011,679000
aarakshan (reservation),Relbig.,651000,0,2011,651000
pom wonderful presents: the greatest movie ever sold,SPC,638000,0,2011,638000
no one killed jessica,UTV,441000,193000,2011,634000
korkoro,Lorb.,8200,619000,2011,627200
blackthorn,Magn.,201000,423000,2011,624000
how i ended this summer,FM,8700,614000,2011,622700
the ledge,IFC,9200,602000,2011,611200
heartbeats,IFC,68700,520000,2011,588700
the future,RAtt.,569000,0,2011,569000
dum maaro dum,FoxS,564000,0,2011,564000
double dhamaal,Relbig.,544000,0,2011,544000
kaboom,IFC,119000,421000,2011,540000
mere brother ki dulhan,Yash,496000,0,2011,496000
weekend (2011),IFC,485000,0,2011,485000
protektor,FM,3000,469000,2011,472000
circumstance,RAtt.,454000,0,2011,454000
the other woman,IFC,25400,427000,2011,452400
project nim,RAtt.,411000,0,2011,411000
rage (rabia),Strand,5600,403000,2011,408600
the human resources manager,FM,64000,329000,2011,393000
hesher,WHE,383000,0,2011,383000
7 khoon maaf,UTV,270000,94700,2011,364700
another happy day,P4,8500,347000,2011,355500
singham,Relbig.,351000,0,2011,351000
the mill and the cross,KC,312000,30300,2011,342300
super,IFC,328000,0,2011,328000
l'amour fou,IFC,312000,0,2011,312000
being elmo: a puppeteer's journey,SD,304000,0,2011,304000
in the land of blood and honey,FD,304000,0,2011,304000
special treatment,FRun,8900,286000,2011,294900
illegal (2011),FM,700,289000,2011,289700
the interrupters,CGld,282000,0,2011,282000
rascals,Eros,274000,0,2011,274000
the black power mix tape: 1967-1975,IFC,274000,0,2011,274000
black death,Magn.,22600,243000,2011,265600
le quattro volte,Lorb.,153000,103000,2011,256000
life in a day,NGE,253000,0,2011,253000
caterpillar,Lorb.,4200,248000,2011,252200
little girl (la pivellina),FRun,1400,236000,2011,237400
el bulli: cooking in progress,AM,237000,0,2011,237000
"if i want to whistle, i whistle",FM,12100,220000,2011,232100
into the abyss,IFC,224000,0,2011,224000
happythankyoumoreplease,Anch.,216000,0,2011,216000
the robber,Kino,83500,125000,2011,208500
henry's crime,MPFT,103000,102000,2011,205000
a good old fashioned orgy,Gold.,200000,0,2011,200000
film socialisme,Lorb.,33000,159000,2011,192000
bol,Eros,189000,0,2011,189000
leap year (2011),Strand,13000,175000,2011,188000
a screaming man,FM,9900,175000,2011,184900
jig,Scre.,184000,0,2011,184000
nostalgia for the light,Icar.,164000,13700,2011,177700
anchor baby,AGF,15800,161000,2011,176800
bellflower,Osci.,168000,0,2011,168000
restless (2011),SPC,163000,0,2011,163000
road to nowhere,Mont.,40300,121000,2011,161300
magic trip,Magn.,155000,0,2011,155000
eames: the architect and the painter,FRun,153000,0,2011,153000
revenge of the electric car,A23,151000,0,2011,151000
the human centipede 2: full sequence,IFC,142000,0,2011,142000
cold weather,IFC,141000,0,2011,141000
game (2011),Eros,140000,0,2011,140000
1911,Vari.,136000,0,2011,136000
"life, above all",SPC,134000,0,2011,134000
tomboy (2011),Da.,130000,0,2011,130000
octubre,NYer,32100,96700,2011,128800
the arbor,Strand,21600,105000,2011,126600
mysteries of lisbon,MBox,111000,14900,2011,125900
vidal sassoon: the movie,P4,86000,38600,2011,124600
trust (2011),MNE,120000,0,2011,120000
steve jobs: the lost interview,Magn.,106000,0,2011,106000
rubber,Magn.,100000,0,2011,100000
the man who fell to earth (35th anniversary re-issue),Rialto,100000,0,2011,100000
chalo dilli,Eros,94300,0,2011,94300
the whale,Pala.,81900,0,2011,81900
beautiful boy,Anch.,77200,0,2011,77200
puncture,MNE,68900,0,2011,68900
a beautiful life,CL,66200,0,2011,66200
"tuesday, after christmas",Lorb.,27800,36200,2011,64000
viva riva!,MBox,61800,0,2011,61800
murder 2,Eros,59500,0,2011,59500
dirty girl,Wein.,55100,0,2011,55100
battleship potemkin (2011 re-issue),Kino,51200,0,2011,51200
love u mr. kalakaar,Eros,48600,0,2011,48600
margaret,FoxS,46500,0,2011,46500
"happy, happy",Magn.,45200,0,2011,45200
the myth of the american sleepover,IFC,41000,0,2011,41000
hell and back again,DF,40600,0,2011,40600
khodorkovsky,KL,39500,0,2011,39500
sleeping beauty (2011) (ii),IFC,36600,0,2011,36600
my kingdom (2011),CL,36500,0,2011,36500
love in space,CL,34800,0,2011,34800
stake land,IFC,33200,0,2011,33200
brotherhood (2011),P4,19700,12700,2011,32400
the son of no one,Anch.,30700,0,2011,30700
muran,UTV,30100,0,2011,30100
the sleeping beauty,Strand,29100,0,2011,29100
tyrannosaur,Strand,22300,0,2011,22300
ceremony,Magn.,22300,0,2011,22300
i'm glad my mother is alive,Strand,8700,13200,2011,21900
always kabhi kabhi,Eros,21400,0,2011,21400
empire of silver,NeoC,0,19000,2011,19000
5 days of war,Anch.,17500,0,2011,17500
aurora,CGld,5700,5100,2011,10800
magic to win,CL,10700,0,2011,10700
wrecked,IFC,8000,0,2011,8000
my piece of the pie,IFC,6900,0,2011,6900
i melt with you,Magn.,6400,0,2011,6400
my joy,KL,6300,0,2011,6300
to die like a man,Strand,4000,900,2011,4900
blood ties,ALP,2800,0,2011,2800
knuckle,Vita.,2600,0,2011,2600
main street,Magn.,2600,0,2011,2600
"love, wedding, marriage",IFC,1900,0,2011,1900
an invisible sign,IFC,1300,0,2011,1300
marvel's the avengers,BV,623400000,895500000,2012,1518900000
skyfall,Sony,304400000,804200000,2012,1108600000
the dark knight rises,WB,448100000,636800000,2012,1084900000
the hobbit: an unexpected journey,WB (NL),303000000,718100000,2012,1021100000
ice age: continental drift,Fox,161300000,715900000,2012,877200000
the twilight saga: breaking dawn part 2,LG/S,292300000,537400000,2012,829700000
the amazing spider-man,Sony,262000000,495900000,2012,757900000
madagascar 3: europe's most wanted,P/DW,216400000,530500000,2012,746900000
the hunger games,LGF,408000000,286400000,2012,694400000
mib 3,Sony,179000000,445000000,2012,624000000
life of pi,Fox,125000000,484000000,2012,609000000
ted,Uni.,218800000,330600000,2012,549400000
brave,BV,237300000,303200000,2012,540500000
wreck-it ralph,BV,189400000,281800000,2012,471200000
les miserables (2012),Uni.,148800000,293000000,2012,441800000
the intouchables (u.s.-only),Wein.,10200000,416400000,2012,426600000
django unchained,Wein.,162800000,262600000,2012,425400000
prometheus,Fox,126500000,276900000,2012,403400000
snow white and the huntsman,Uni.,155300000,241300000,2012,396600000
taken 2,Fox,139900000,236300000,2012,376200000
hotel transylvania,Sony,148300000,210100000,2012,358400000
dr. seuss' the lorax,Uni.,214000000,134800000,2012,348800000
titanic 3d,Par.,57900000,285700000,2012,343600000
journey 2: the mysterious island,WB (NL),103900000,231400000,2012,335300000
the expendables 2,LGF,85000000,229900000,2012,314900000
rise of the guardians,P/DW,103400000,203500000,2012,306900000
wrath of the titans,WB,83700000,221600000,2012,305300000
battleship,Uni.,65400000,237600000,2012,303000000
john carter,BV,73100000,211100000,2012,284200000
the bourne legacy,Uni.,113200000,162900000,2012,276100000
lincoln,BV,182200000,93100000,2012,275300000
dark shadows,WB,79700000,165800000,2012,245500000
resident evil: retribution,SGem,42300000,197700000,2012,240000000
silver linings playbook,Wein.,132100000,104300000,2012,236400000
american reunion,Uni.,57000000,178000000,2012,235000000
argo,WB,136000000,96300000,2012,232300000
jack reacher,Par.,80100000,138300000,2012,218400000
safe house,Uni.,126400000,81700000,2012,208100000
21 jump street,Sony,138400000,63100000,2012,201500000
total recall (2012),Sony,58900000,139600000,2012,198500000
the vow,SGem,125000000,71100000,2012,196100000
mirror mirror,Rela.,64900000,118100000,2012,183000000
the impossible,LG/S,19000000,161300000,2012,180300000
the dictator,Par.,59700000,119700000,2012,179400000
looper,TriS,66500000,110000000,2012,176500000
magic mike,WB,113700000,53500000,2012,167200000
flight,Par.,93800000,68000000,2012,161800000
underworld awakening,SGem,62300000,97800000,2012,160100000
this means war,Fox,54800000,101700000,2012,156500000
the secret world of arrietty,BV,19200000,126400000,2012,145600000
paranormal activity 4,Par.,53900000,88900000,2012,142800000
step up revolution,LG/S,35100000,105400000,2012,140500000
the best exotic marigold hotel,FoxS,46400000,90400000,2012,136800000
zero dark thirty,Sony,95700000,37100000,2012,132800000
ghost rider: spirit of vengeance,Sony,51800000,80800000,2012,132600000
cloud atlas,WB,27100000,103400000,2012,130500000
the woman in black,CBS,54300000,73400000,2012,127700000
chronicle (2012),Fox,64599999,62100000,2012,126699999
the pirates! band of misfits,Sony,31100000,92000000,2012,123100000
parental guidance,Fox,77300000,42500000,2012,119800000
abraham lincoln: vampire hunter,Fox,37500000,79000000,2012,116500000
pitch perfect,Uni.,65000000,50300000,2012,115300000
hope springs,Sony,63500000,50700000,2012,114200000
paranorman,Focus,56000000,51100000,2012,107100000
the campaign,WB,86900000,18000000,2012,104900000
let the bullets fly,Vari.,63000,104300000,2012,104363000
star wars: episode i - the phantom menace (in 3d),Fox,43500000,59300000,2012,102800000
project x,WB,54700000,48000000,2012,102700000
the devil inside,Par.,53300000,48500000,2012,101800000
the lucky one,WB,60500000,38900000,2012,99400000
contraband,Uni.,66500000,29700000,2012,96200000
think like a man,SGem,91500000,4500000,2012,96000000
this is 40,Uni.,67500000,20500000,2012,88000000
the inbetweeners movie,WHE,36000,88000000,2012,88036000
the possession,LGF,49100000,36300000,2012,85400000
what to expect when you're expecting,LGF,41200000,43200000,2012,84400000
the thieves,WGUSA,686000,82800000,2012,83486000
savages (2012),Uni.,47400000,35600000,2012,83000000
frankenweenie,BV,35300000,46200000,2012,81500000
act of valor,Rela.,70000000,11300000,2012,81300000
masquerade (2012),CJ,923000,79800000,2012,80723000
sinister,LG/S,48100000,29600000,2012,77700000
the grey,ORF,51600000,25700000,2012,77300000
diary of a wimpy kid: dog days,Fox,49000000,28100000,2012,77100000
to rome with love,SPC,16700000,56600000,2012,73300000
here comes the boom,Sony,45300000,27800000,2012,73100000
finding nemo (3d),BV,41100000,28200000,2012,69300000
anna karenina,Focus,12800000,56100000,2012,68900000
the watch,Fox,35400000,32900000,2012,68300000
moonrise kingdom,Focus,45500000,22800000,2012,68300000
tyler perry's madea's witness protection,LGF,65700000,1200000,2012,66900000
the cabin in the woods,LGF,42100000,24400000,2012,66500000
beauty and the beast (3d),BV,47600000,14400000,2012,62000000
rock of ages,WB (NL),38500000,20900000,2012,59400000
that's my boy,Sony,36900000,20800000,2012,57700000
the odd life of timothy green,BV,51900000,4200000,2012,56100000
the three stooges,Fox,44300000,10500000,2012,54800000
the five-year engagement,Uni.,28800000,25100000,2012,53900000
lawless,Wein.,37400000,16300000,2012,53700000
silent hill: revelation 3d,ORF,17500000,34800000,2012,52300000
red tails,Fox,49900000,489000,2012,50389000
"monsters, inc. (3d)",BV,34000000,16200000,2012,50200000
trouble with the curve,WB,35800000,13200000,2012,49000000
little white lies,MPI,206000,48300000,2012,48506000
end of watch,ORF,41000000,7100000,2012,48100000
man on a ledge,LG/S,18600000,27600000,2012,46200000
red dawn (2012),FD,44800000,0,2012,44800000
house at the end of the street,Rela.,31600000,12700000,2012,44300000
the guilt trip,Par.,37100000,4700000,2012,41800000
a werewolf boy,CJ,343000,41300000,2012,41643000
safe (2012),LGF,17100000,23200000,2012,40300000
killing them softly,Wein.,15000000,22900000,2012,37900000
chernobyl diaries,WB,18100000,19000000,2012,37100000
one for the money,LGF,26400000,10500000,2012,36900000
dredd,LGF,13400000,22200000,2012,35600000
tyler perry's good deeds,LGF,35000000,553000,2012,35553000
arbitrage,RAtt.,7900000,27600000,2012,35500000
chimpanzee,BV,29000000,5900000,2012,34900000
alex cross,LG/S,25900000,8700000,2012,34600000
salmon fishing in the yemen,CBS,9000000,25500000,2012,34500000
fetih 1453: the conquest of constantinople,NeoC,35700,34400000,2012,34435700
cirque du soleil: worlds away,Par.,12500000,21600000,2012,34100000
the perks of being a wallflower,LG/S,17700000,15600000,2012,33300000
haywire,Rela.,18900000,14400000,2012,33300000
katy perry: part of me,Par.,25300000,7400000,2012,32700000
lockout,FD,14300000,17900000,2012,32200000
joyful noise,WB,30900000,226000,2012,31126000
premium rush,Sony,20300000,10800000,2012,31100000
the raven,Rela.,16000000,13600000,2012,29600000
rowdy rathore,UTV,777000,28600000,2012,29377000
dragon (2012),RTWC,11100,29100000,2012,29111100
bol bachchan,FIP,1200000,27600000,2012,28800000
the master,Wein.,16399999,11900000,2012,28299999
rust and bone,SPC,2100000,23700000,2012,25800000
big miracle,Uni.,20200000,4600000,2012,24800000
sparkle (2012),TriS,24400000,240000,2012,24640000
to the arctic (imax),WB,14600000,9100000,2012,23700000
hitchcock,FoxS,6000000,17600000,2012,23600000
a thousand words,P/DW,18500000,3600000,2012,22100000
wanderlust,Uni.,17500000,4200000,2012,21700000
beasts of the southern wild,FoxS,12800000,8300000,2012,21100000
polisse,IFC,211000,20200000,2012,20411000
amour,SPC,6700000,13100000,2012,19800000
the man with the iron fists,Uni.,15600000,4099999,2012,19699999
solomon kane,RTWC,0,19600000,2012,19600000
seven psychopaths,CBS,15000000,4400000,2012,19400000
gone,LG/S,11700000,6400000,2012,18100000
norwegian wood,RF,13000,17600000,2012,17613000
the cold light of day,LG/S,3800000,13100000,2012,16900000
my way (2012),CJ,70200,16500000,2012,16570200
tomorrow when the war began,Free,4900,16500000,2012,16504900
we have a pope,IFC,548000,15600000,2012,16148000
headhunters,Magn.,1200000,14500000,2012,15700000
hit and run,ORF,13700000,704000,2012,14404000
war of the buttons (2012),Wein.,47800,13800000,2012,13847800
red lights (2012),MNE,52600,13500000,2012,13552600
the words,CBS,11500000,1700000,2012,13200000
playing for keeps,FD,13100000,0,2012,13100000
silent house,ORF,12800000,347000,2012,13147000
friends with kids,RAtt.,7300000,5800000,2012,13100000
the well-digger's daughter,KL,386000,12200000,2012,12586000
klown,Drft.,68800,12400000,2012,12468800
people like us,BV,12400000,0,2012,12400000
seeking justice,Anch.,412000,11900000,2012,12312000
bachelorette,RTWC,448000,11500000,2012,11948000
this must be the place,Wein.,144000,11600000,2012,11744000
fun size,Par.,9400000,2000000,2012,11400000
rec 3: genesis,Magn.,9600,10100000,2012,10109600
delicacy,Cohen,499000,9200000,2012,9699000
seeking a friend for the end of the world,Focus,7100000,2600000,2012,9700000
the apparition,WB,4900000,4700000,2012,9600000
for greater glory,ArcEnt,5700000,4000000,2012,9700000
hysteria,SPC,1800000,7700000,2012,9500000
bernie,MNE,9200000,0,2012,9200000
the sessions,FoxS,6000000,3100000,2012,9100000
ruby sparks,FoxS,2500000,6600000,2012,9100000
hyde park on hudson,Focus,6400000,2500000,2012,8900000
on the road,IFC,744000,8000000,2012,8744000
boy (2012),PalUni,256000,8400000,2012,8656000
piranha 3dd,W/Dim.,377000,8100000,2012,8477000
easy money (2012),Wein.,206000,8199999,2012,8405999
space dogs 3d,EpicPics,14400,8300000,2012,8314400
bel ami,Magn.,120000,8199999,2012,8319999
promised land (2012),Focus,7600000,541000,2012,8141000
iron sky,EOne,122000,8000000,2012,8122000
casa de mi padre,LGF,5900000,2100000,2012,8000000
heroine,UTV,599000,7400000,2012,7999000
a royal affair,Magn.,1500000,6000000,2012,7500000
all together,KL,43200,7200000,2012,7243200
my worst nightmare,Strand,22000,7100000,2012,7122000
the collection,LD,6800000,0,2012,6800000
monsieur lazhar (u.s.-only),MBox,2000000,4600000,2012,6600000
goon,Magn.,4200000,2300000,2012,6500000
cosmopolis,EOne,764000,5300000,2012,6064000
chasing mavericks,Fox,6000000,600,2012,6000600
declaration of war,IFC,59100,5800000,2012,5859100
puella magi madoka magica the movie,Elev.,180000,5600000,2012,5780000
albert nobbs,RAtt.,3000000,2600000,2012,5600000
in darkness,SPC,1000000,4500000,2012,5500000
won't back down,Fox,5300000,0,2012,5300000
farewell my queen,Cohen,1600000,3700000,2012,5300000
the tall man,Imag.,0,5200000,2012,5200000
girl in progress,LGF,2600000,2000000,2012,4600000
"jeff, who lives at home",ParV,4300000,148000,2012,4448000
barbara,AF,1000000,3100000,2012,4100000
the raid: redemption,SPC,4099999,0,2012,4099999
safety not guaranteed,FD,4000000,0,2012,4000000
nitro circus the movie 3d,ArcEnt,3400000,526000,2012,3926000
"lula, son of brazil",NYer,0,3800000,2012,3800000
the lady,Cohen,355000,3400000,2012,3755000
branded,RAtt.,354000,3400000,2012,3754000
the rabbi's cat,GK,23400,3700000,2012,3723400
searching for sugar man,SPC,3700000,0,2012,3700000
killer joe,LD,2000000,1700000,2012,3700000
hara-kiri: death of a samurai,Trib.,75700,3400000,2012,3475700
robot & frank,Gold.,3300000,0,2012,3300000
raiders of the lost ark (imax),Par.,3100000,0,2012,3100000
celeste and jesse forever,SPC,3100000,0,2012,3100000
jab tak hai jaan,Yash,3000000,0,2012,3000000
intruders,MNE,69100,2900000,2012,2969100
talaash,Relbig.,2900000,0,2012,2900000
barfi!,UTV,2800000,0,2012,2800000
a simple life,CL,192000,2600000,2012,2792000
samsara,Osci.,2700000,0,2012,2700000
simon and the oaks,TFA,151000,2400000,2012,2551000
jiro dreams of sushi,Magn.,2600000,0,2012,2600000
dabangg 2,Eros,2500000,0,2012,2500000
kid with a bike,IFC,1500000,1000000,2012,2500000
the queen of versailles,Magn.,2400000,0,2012,2400000
ek tha tiger,Yash,2300000,0,2012,2300000
chico & rita,GK,351000,1900000,2012,2251000
stolen (2012),MNE,304000,1800000,2012,2104000
footnote,SPC,2000000,0,2012,2000000
the imposter,IM,898000,1100000,2012,1998000
agneepath,Eros,2000000,0,2012,2000000
the day i saw your heart,FM,3500,2000000,2012,2003500
english vinglish,Eros,1900000,0,2012,1900000
housefull 2,Eros,1800000,0,2012,1800000
the cup (2012),Myr.,0,1800000,2012,1800000
tales of the night,GK,11000,1700000,2012,1711000
beloved (2012),IFC,138000,1500000,2012,1638000
360,Magn.,100000,1600000,2012,1700000
2 days in new york,Magn.,633000,1000000,2012,1633000
your sister's sister,IFC,1600000,0,2012,1600000
hermano,MBox,29900,1600000,2012,1629900
lay the favorite,RTWC,21000,1600000,2012,1621000
soldiers of fortune,RAtt.,38900,1500000,2012,1538900
a late quartet,EOne,1600000,0,2012,1600000
i wish,Magn.,146000,1400000,2012,1546000
the salt of life,Zeit.,317000,1200000,2012,1517000
chicken with plums,SPC,254000,1200000,2012,1454000
marley,Magn.,1400000,0,2012,1400000
the paperboy,MNE,693000,661000,2012,1354000
chasing ice,SD,1300000,0,2012,1300000
unforgivable,Strand,154000,1200000,2012,1354000
a little bit of heaven,MNE,15400,1300000,2012,1315400
the other son,Cohen,1300000,0,2012,1300000
meerkats,NGE,778000,482000,2012,1260000
"for a good time, call...",Focus,1300000,0,2012,1300000
take this waltz,Magn.,1200000,0,2012,1200000
cocktail (2012),Eros,1200000,0,2012,1200000
once upon a time in anatolia,CGld,152000,1000000,2012,1152000
ek main aur ekk tu,UTV,1200000,0,2012,1200000
the deep blue sea,MBox,1100000,0,2012,1100000
coriolanus,Wein.,757000,315000,2012,1072000
diana vreeland: the eye has to travel,Gold.,1000000,0,2012,1000000
first position,IFC,1000000,0,2012,1000000
damsels in distress,SPC,1000000,0,2012,1000000
rampart,MNE,973000,0,2012,973000
elles,KL,158000,754000,2012,912000
w.e.,Wein.,583000,285000,2012,868000
breathing,KL,4600,803000,2012,807600
darling companion,SPC,794000,0,2012,794000
teri meri kahaani,Eros,781000,0,2012,781000
son of sardaar,Eros,772000,0,2012,772000
agent vinod,Eros,698000,0,2012,698000
student of the year,Eros,670000,0,2012,670000
the polar express (2012 re-issue),WB,669000,0,2012,669000
holy motors,IM,641000,0,2012,641000
free men,FM,53800,564000,2012,617800
"peace, love and misunderstanding",IFC,591000,0,2012,591000
undefeated (2012),Wein.,562000,0,2012,562000
sister (2012),AF,155000,400000,2012,555000
vicky donor,Eros,549000,0,2012,549000
being flynn,Focus,540000,0,2012,540000
ai weiwei: never sorry,IFC,534000,0,2012,534000
where do we go now?,SPC,532000,0,2012,532000
bully (2012),Wein.,279000,182000,2012,461000
ferrari ki sawaari,Eros,434000,0,2012,434000
dark tide,WHE,0,432000,2012,432000
apartment 143,Magn.,400,426000,2012,426400
sound of my voice,FoxS,408000,0,2012,408000
khiladi 786,Eros,379000,0,2012,379000
smashed,SPC,377000,0,2012,377000
universal soldier: day of reckoning,Magn.,5500,364000,2012,369500
the oranges,ATO,366000,0,2012,366000
liberal arts,IFC,327000,0,2012,327000
compliance,Magn.,319000,0,2012,319000
back to 1942,CL,313000,0,2012,313000
the flowers of war,WHE,311000,0,2012,311000
something from nothing: the art of rap,IM,288000,0,2012,288000
love in the buff,CL,256000,0,2012,256000
lola versus,FoxS,253000,0,2012,253000
keep the lights on,MBox,246000,0,2012,246000
gerhard richter painting,KL,243000,0,2012,243000
trishna,IFC,240000,0,2012,240000
elena,Zeit.,233000,0,2012,233000
tezz,Eros,230000,0,2012,230000
the viral factor,CL,220000,0,2012,220000
neil young journeys,SPC,215000,0,2012,215000
tai chi zero,Vari.,212000,0,2012,212000
the house i live in,Abr.,211000,0,2012,211000
10 years,Anch.,203000,0,2012,203000
17 girls,Strand,15100,186000,2012,201100
tim & eric's billion dollar movie,Magn.,201000,0,2012,201000
any day now,MBox,201000,0,2012,201000
tere naal love ho gaya,UTV,178000,0,2012,178000
the hunter (2012),Magn.,177000,0,2012,177000
butter,RTWC,105000,70700,2012,175700
kill list,IFC,29100,143000,2012,172100
flying swords of dragon gate,IM,170000,0,2012,170000
joker,UTV,169000,0,2012,169000
dark horse,BM&DH,166000,0,2012,166000
shirin farhad ki toh nikal padi,Eros,156000,0,2012,156000
bullhead,Drft.,152000,0,2012,152000
chakravyuh,Eros,152000,0,2012,152000
luv shuv tey chicken khurana,UTV,144000,0,2012,144000
high school,Anch.,139000,0,2012,139000
warriors of the rainbow: seediq bale,WGUSA,136000,0,2012,136000
the loneliest planet,IFC,130000,0,2012,130000
forgiveness of blood,IFC,127000,0,2012,127000
toys in the attic,Hann.,64900,61600,2012,126500
"turn me on, dammit!",NYer,126000,0,2012,126000
god bless america,Magn.,123000,0,2012,123000
bullet vanishes,CL,118000,0,2012,118000
the woman in the fifth,ATO,114000,0,2012,114000
5 broken cameras,KL,110000,0,2012,110000
hello i must be going,Osci.,107000,0,2012,107000
the magic of belle isle,Magn.,102000,0,2012,102000
"oslo, august 31st",Strand,101000,0,2012,101000
wuthering heights (2012),Osci.,101000,0,2012,101000
mugamoodi,UTV,101000,0,2012,101000
v/h/s,Magn.,100000,0,2012,100000
goodbye first love,IFC,95000,0,2012,95000
marina abramovic: the artist is present,MBox,86600,0,2012,86600
the eye of the storm,SEG,83600,0,2012,83600
wagner & me,FRun,37700,41000,2012,78700
the innkeepers,Magn.,78400,0,2012,78400
this is not a film,PalT,77000,0,2012,77000
the island president,Gold.,76400,0,2012,76400
detachment,Trib.,72700,0,2012,72700
the green wave,RF,0,70100,2012,70100
attenberg,Strand,24000,45900,2012,69900
deadfall (2012),Magn.,66400,0,2012,66400
girlfriend boyfriend - gf bf,CL,64400,0,2012,64400
vulgaria,CL,59100,0,2012,59100
the turin horse,CGld,56400,0,2012,56400
jodi breakers,Yash,52600,0,2012,52600
painted skin: the resurrection,WGUSA,50400,0,2012,50400
"all's well, end's well (2012)",CL,47900,0,2012,47900
north sea texas,Strand,28300,16700,2012,45000
double trouble,CL,44800,0,2012,44800
the fairy,KL,38400,0,2012,38400
hit so hard,Vari.,34000,0,2012,34000
kalakalappu@masala cafe,UTV,30900,0,2012,30900
the bay,RAtt.,30700,0,2012,30700
you've been trumped,ICir,29300,0,2012,29300
here (2012),Strand,26700,0,2012,26700
in another country,KL,25100,0,2012,25100
the first time,Gold.,22800,0,2012,22800
bonsai,Strand,21300,0,2012,21300
the day,Anch.,21000,0,2012,21000
28 hotel rooms,Osci.,18900,0,2012,18900
lovely molly,Imag.,18500,0,2012,18500
juan of the dead,Outs,18000,0,2012,18000
4:44: last day on earth,IFC,17800,0,2012,17800
little birds,MNE,17700,0,2012,17700
return (2012),Da.,16100,0,2012,16100
alps,KL,16100,0,2012,16100
patience (after sebald),CGld,15900,0,2012,15900
take me home,Mont.,15800,0,2012,15800
reuniting the rubins,Mont.,13600,0,2012,13600
cirkus columbia,Strand,3500,9500,2012,13000
grassroots,Gold.,12400,0,2012,12400
husbands in goa,UTV,10100,0,2012,10100
starry starry night,CL,10000,0,2012,10000
corpo celeste,FM,8900,0,2012,8900
dreams of a life,Strand,8400,0,2012,8400
the babymakers,MNE,7900,0,2012,7900
las acacias,OutF,6000,0,2012,6000
the good doctor,Magn.,5200,0,2012,5200
liar's autobiography,BSM,5100,0,2012,5100
sleepless night,Trib.,3400,0,2012,3400
atm,IFC,3000,0,2012,3000
about cherry,IFC,3000,0,2012,3000
perfect sense,IFC,3000,0,2012,3000
cheerful weather for the wedding,IFC,2700,0,2012,2700
the decoy bride,IFC,800,0,2012,800
death of a superhero,Trib.,600,0,2012,600
frozen,BV,400700000,875700000,2013,1276400000
iron man 3,BV,409000000,805800000,2013,1214800000
despicable me 2,Uni.,368100000,602700000,2013,970800000
the hobbit: the desolation of smaug,WB (NL),258399999,700000000,2013,958399999
the hunger games: catching fire,LGF,424700000,440300000,2013,865000000
fast & furious 6,Uni.,238700000,550000000,2013,788700000
monsters university,BV,268500000,475700000,2013,744200000
gravity,WB,274100000,449100000,2013,723200000
man of steel,WB,291000000,377000000,2013,668000000
thor: the dark world,BV,206400000,438200000,2013,644600000
the croods,Fox,187200000,400000000,2013,587200000
world war z,Par.,202400000,337600000,2013,540000000
oz the great and powerful,BV,234900000,258399999,2013,493299999
star trek into darkness,Par.,228800000,238600000,2013,467400000
the wolverine,Fox,132600000,282300000,2013,414900000
pacific rim,WB,101800000,309200000,2013,411000000
the wolf of wall street,Par.,116900000,275100000,2013,392000000
g.i. joe: retaliation,Par.,122500000,253200000,2013,375700000
the hangover part iii,WB,112200000,249800000,2013,362000000
the great gatsby (2013),WB,144800000,208800000,2013,353600000
now you see me,LG/S,117700000,234000000,2013,351700000
the smurfs 2,Sony,71000000,276500000,2013,347500000
the conjuring,WB (NL),137400000,182100000,2013,319500000
a good day to die hard,Fox,67300000,237300000,2013,304600000
oblivion,Uni.,89100000,197100000,2013,286200000
elysium,TriS,93100000,193100000,2013,286200000
turbo,Fox,83000000,199500000,2013,282500000
cloudy with a chance of meatballs 2,Sony,119800000,154500000,2013,274300000
we're the millers,WB (NL),150400000,119600000,2013,270000000
epic,Fox,107500000,160900000,2013,268400000
the lone ranger,BV,89300000,171200000,2013,260500000
american hustle,Sony,150100000,101100000,2013,251200000
grown ups 2,Sony,133699999,113300000,2013,246999999
after earth,Sony,60500000,183300000,2013,243800000
planes,BV,90300000,149000000,2013,239300000
the heat,Fox,159600000,70300000,2013,229900000
hansel and gretel: witch hunters,Par.,55700000,170600000,2013,226300000
captain phillips,Sony,107100000,111700000,2013,218800000
white house down,Sony,73100000,132300000,2013,205400000
percy jackson: sea of monsters,Fox,68600000,131300000,2013,199900000
lost in thailand,WAMCR,57400,197700000,2013,197757400
jack the giant slayer,WB (NL),65200000,132500000,2013,197700000
the secret life of walter mitty,Fox,58200000,129900000,2013,188100000
12 years a slave,FoxS,56700000,131100000,2013,187800000
lee daniels' the butler,Wein.,116600000,60000000,2013,176600000
identity thief,Uni.,134500000,39500000,2013,174000000
anchorman 2: the legend continues,Par.,125200000,46300000,2013,171500000
olympus has fallen,FD,98900000,71300000,2013,170200000
insidious chapter 2,FD,83600000,78300000,2013,161900000
lone survivor,Uni.,125100000,29700000,2013,154800000
jackass presents: bad grandpa,Par.,102000000,49800000,2013,151800000
47 ronin,Uni.,38400000,113400000,2013,151800000
red 2,LG/S,53300000,94800000,2013,148100000
mama,Uni.,71600000,74800000,2013,146400000
escape plan,LG/S,25100000,112200000,2013,137300000
last vegas,CBS,63900000,70500000,2013,134400000
2 guns,Uni.,75600000,56300000,2013,131900000
walking with dinosaurs,Fox,36100000,90500000,2013,126600000
this is the end,Sony,101500000,24600000,2013,126100000
ender's game,LG/S,61700000,63800000,2013,125500000
prisoners,WB,61000000,61100000,2013,122100000
saving mr. banks,BV,83300000,34600000,2013,117900000
warm bodies,LG/S,66400000,50600000,2013,117000000
jurassic park 3d,Uni.,45400000,71100000,2013,116500000
personal tailor,CL,376000,115800000,2013,116176000
free birds,Rela.,55800000,54600000,2013,110400000
gangster squad,WB,46000000,59200000,2013,105200000
philomena,Wein.,37700000,62400000,2013,100100000
instructions not included,LGF,44500000,54600000,2013,99100000
riddick,Uni.,42000000,56300000,2013,98300000
safe haven,Rela.,71300000,26200000,2013,97500000
evil dead (2013),TriS,54200000,43300000,2013,97500000
blue jasmine,SPC,33400000,64099999,2013,97499999
the mortal instruments: city of bones,SGem,31200000,64200000,2013,95400000
the internship,Fox,44700000,48800000,2013,93500000
rush (2013),Uni.,26900000,63300000,2013,90200000
the purge,Uni.,64500000,24900000,2013,89400000
dhoom 3,Yash,8000000,80000000,2013,88000000
about time,Uni.,15300000,71800000,2013,87100000
pain and gain,Par.,49900000,36300000,2013,86200000
carrie (2013),SGem,35300000,49500000,2013,84800000
the family (2013),Rela.,36900000,41500000,2013,78400000
scary movie 5,W/Dim.,32000000,46400000,2013,78400000
r.i.p.d.,Uni.,33600000,44700000,2013,78300000
tiny times,CL,23500,77700000,2013,77723500
the book thief,Fox,21500000,55100000,2013,76600000
escape from planet earth,Wein.,57000000,17600000,2013,74600000
august: osage county,Wein.,37700000,36500000,2013,74200000
the best man holiday,Uni.,70500000,2300000,2013,72800000
young detective dee: rise of the sea dragon,WAMCR,87800,72200000,2013,72287800
the counselor,Fox,17000000,54000000,2013,71000000
the call,TriS,51900000,16700000,2013,68600000
one direction: this is us,TriS,28900000,39700000,2013,68600000
the grandmaster,Wein.,6600000,57500000,2013,64100000
side effects (2013),ORF,32200000,31200000,2013,63400000
the host (2013),ORF,26600000,36700000,2013,63300000
runner runner,Fox,19300000,43400000,2013,62700000
from up on poppy hill,GK,1000000,60000000,2013,61000000
kick-ass 2,Uni.,28800000,32000000,2013,60800000
a haunted house,ORF,40000000,20100000,2013,60100000
beautiful creatures (2013),WB,19500000,40600000,2013,60100000
quartet,Wein.,18400000,41100000,2013,59500000
dallas buyers club,Focus,27300000,27900000,2013,55200000
the face reader,PM&E,516000,54100000,2013,54616000
tyler perry's a madea christmas,LGF,52500000,853000,2013,53353000
tyler perry's temptation: confessions of a marriage counselor,LGF,52000000,1200000,2013,53200000
delivery man,BV,30700000,19300000,2013,50000000
the berlin file,CJ,665000,48300000,2013,48965000
the last stand,LGF,12100000,36300000,2013,48400000
21 and over,Rela.,25700000,22400000,2013,48100000
her (2013),WB,25600000,21800000,2013,47400000
tiny times 2,CL,43800,47200000,2013,47243800
texas chainsaw 3d,LGF,34300000,12900000,2013,47200000
the big wedding,LGF,21800000,24700000,2013,46500000
parker,FD,17600000,28600000,2013,46200000
the world's end,Focus,26000000,20100000,2013,46100000
grudge match,WB,29800000,15100000,2013,44900000
homefront,ORF,20200000,22900000,2013,43100000
snitch,LG/S,42900000,0,2013,42900000
jobs,ORF,16100000,19800000,2013,35900000
the place beyond the pines,Focus,21400000,14100000,2013,35500000
inside llewyn davis,CBS,13200000,19700000,2013,32900000
mud,RAtt.,21600000,11000000,2013,32600000
movie 43,Rela.,8800000,23600000,2013,32400000
kevin hart: let me explain,LG/S,32200000,74000,2013,32274000
spring breakers,A24,14100000,17600000,2013,31700000
new world (2013),WGUSA,458000,31200000,2013,31658000
don jon,Rela.,24500000,6000000,2013,30500000
i give it a year,Magn.,34700,28200000,2013,28234700
nebraska,Par.,17700000,10000000,2013,27700000
the incredible burt wonderstone,WB (NL),22500000,4900000,2013,27400000
mandela: long walk to freedom,Wein.,8300000,19000000,2013,27300000
khumba,MNE,1000,27200000,2013,27201000
dark skies,W/Dim.,17400000,9000000,2013,26400000
enough said,FoxS,17600000,7700000,2013,25300000
trance,FoxS,2300000,21900000,2013,24200000
"the way, way back",FoxS,21500000,1700000,2013,23200000
kon-tiki,Wein.,1500000,21300000,2013,22800000
baggage claim,FoxS,21600000,887000,2013,22487000
diana,EOne,335000,21400000,2013,21735000
the great beauty,Jan.,2900000,18500000,2013,21400000
22 bullets,Cdgm.,0,21300000,2013,21300000
the sapphires,Wein.,2500000,18000000,2013,20500000
broken city,Fox,19700000,0,2013,19700000
the company you keep,SPC,5100000,14500000,2013,19600000
the bling ring,A24,5800000,13300000,2013,19100000
you're next,LGF,18500000,0,2013,18500000
dead man down,FD,10900000,7200000,2013,18100000
admission,Focus,18000000,0,2013,18000000
fruitvale station,Wein.,16100000,1300000,2013,17400000
battle of the year,SGem,8900000,7700000,2013,16600000
out of the furnace,Rela.,11300000,4300000,2013,15600000
billy and buddy,Distrib.,900,15200000,2013,15200900
the last exorcism part ii,CBS,15200000,0,2013,15200000
machete kills,ORF,8000000,7000000,2013,15000000
journey to the south pacific,Imax,7600000,6500000,2013,14100000
paranoia,Rela.,7400000,6400000,2013,13800000
all is lost,RAtt.,6300000,7400000,2013,13700000
puella magi madoka magica the movie: rebellion,Elev.,376000,12600000,2013,12976000
stoker,FoxS,1700000,10400000,2013,12100000
in the house,Cohen,390000,11500000,2013,11890000
i'm so excited,SPC,1400000,10400000,2013,11800000
haute cuisine,Wein.,218000,11200000,2013,11418000
before midnight,SPC,8100000,3100000,2013,11200000
only god forgives,RTWC,779000,9900000,2013,10679000
the past,SPC,1300000,9300000,2013,10600000
love is all you need,SPC,1600000,8400000,2013,10000000
bullet to the head,WB,9500000,0,2013,9500000
tyler perry presents peeples,LGF,9200000,130000,2013,9330000
jerusalem,NGE,8000000,1300000,2013,9300000
the fifth estate,BV,3300000,5300000,2013,8600000
upside down,MNE,105000,8000000,2013,8105000
metallica through the never,PH,3400000,4600000,2013,8000000
pulling strings,LGF,5800000,2000000,2013,7800000
black nativity,FoxS,7000000,436000,2013,7436000
blue is the warmest color,IFC,2200000,5200000,2013,7400000
unfinished song,Wein.,1700000,5300000,2013,7000000
the angels' share,IFC,347000,6700000,2013,7047000
the spectacular now,A24,6900000,0,2013,6900000
the sweeney,EOne,26700,6300000,2013,6326700
believe,ORF,6200000,0,2013,6200000
matru ki bijlee ka mandola,FIP,0,6000000,2013,6000000
closed circuit,Focus,5800000,0,2013,5800000
populaire,Wein.,179000,5300000,2013,5479000
broken circle breakdown,Trib.,175000,5300000,2013,5475000
fists of legend,CJ,134000,5300000,2013,5434000
chennai express,UTV,5300000,0,2013,5300000
20 feet from stardom,RTWC,4900000,0,2013,4900000
oldboy (2013),FD,2200000,2700000,2013,4900000
commitment,WGUSA,76500,4500000,2013,4576500
white elephant,Strand,8900,4400000,2013,4408900
much ado about nothing (2013),RAtt.,4300000,0,2013,4300000
frances ha,IFC,4099999,0,2013,4099999
you will be my son,Cohen,285000,3600000,2013,3885000
yeh jawaani hai deewani,Eros,3800000,0,2013,3800000
pieta,Drft.,22100,3600000,2013,3622100
mental,Da.,17700,3600000,2013,3617700
the to-do list,CBS,3500000,74600,2013,3574600
mr. nobody,Magn.,3600,3500000,2013,3503600
emperor,RAtt.,3300000,0,2013,3300000
stand up guys,LGF,3300000,0,2013,3300000
in a world,RAtt.,3000000,0,2013,3000000
ram-leela,Eros,2700000,0,2013,2700000
capital,Cohen,102000,2400000,2013,2502000
the east,FoxS,2300000,99700,2013,2399700
i'm in love with a church girl,HTR,2400000,0,2013,2400000
no (2013),SPC,2300000,0,2013,2300000
renoir,Gold.,2300000,0,2013,2300000
the christmas candle,ELS,2300000,0,2013,2300000
reality (2013),Osci.,72600,2200000,2013,2272600
krrish 3,Eros,2200000,0,2013,2200000
austenland,SPC,2200000,0,2013,2200000
the sorcerer and the white snake,Magn.,18800,2100000,2013,2118800
the snitch cartel,PI,0,2100000,2013,2100000
the iceman (2013),MNE,2000000,0,2013,2000000
all the boys love mandy lane,RTWC,0,1900000,2013,1900000
fill the void,SPC,1800000,0,2013,1800000
starbuck (u.s. only),E1,340000,1300000,2013,1640000
bhaag milkha bhaag,Relbig.,1600000,0,2013,1600000
therese,MPI,102000,1500000,2013,1602000
stories we tell,RAtt.,1600000,0,2013,1600000
lovelace,RTWC,357000,1200000,2013,1557000
race 2,UTV,1600000,0,2013,1600000
disconnect,LD,1400000,0,2013,1400000
girl most likely,RAtt.,1400000,0,2013,1400000
wadjda (u.s. only),SPC,1300000,0,2013,1300000
the kings of summer,CBS,1300000,0,2013,1300000
the invisible woman,SPC,1200000,0,2013,1200000
violeta went to heaven,KL,21500,1200000,2013,1221500
romeo and juliet (2013),Rela.,1200000,0,2013,1200000
still mine,Gold.,1200000,0,2013,1200000
the wall (2013),MBox,38700,1100000,2013,1138700
kai po che,UTV,1100000,0,2013,1100000
what maisie knew,MNE,1100000,0,2013,1100000
thanks for sharing,RAtt.,1100000,0,2013,1100000
ain't them bodies saints,IFC,397000,635000,2013,1032000
kill your darlings,SPC,1000000,0,2013,1000000
short term 12,Cdgm.,1000000,0,2013,1000000
ginger & rosa,A24,1000000,0,2013,1000000
lore,MBox,970000,0,2013,970000
raanjhana,Eros,903000,0,2013,903000
6 souls,RTWC,0,852000,2013,852000
generation iron,TVC,850000,0,2013,850000
the monk,ATO,13500,794000,2013,807500
satyagraha,UTV,739000,0,2013,739000
hannah arendt,Zeit.,717000,0,2013,717000
besharam,Relbig.,680000,0,2013,680000
salinger,Wein.,584000,67000,2013,651000
the hunt,Magn.,613000,0,2013,613000
walking the camino: six ways to santiago,FEF,613000,0,2013,613000
to the wonder,Magn.,588000,0,2013,588000
lootera,Eros,582000,0,2013,582000
museum hours,CGld,561000,0,2013,561000
the reluctant fundamentalist,IFC,553000,0,2013,553000
you ain't seen nothin' yet,KL,18900,488000,2013,506900
the inevitable defeat of mister and pete,LGF,495000,0,2013,495000
act of killing,Drft.,487000,0,2013,487000
sound city,Vari.,423000,0,2013,423000
shadow dancer,Magn.,101000,319000,2013,420000
a hijacking,Magn.,414000,0,2013,414000
grand masti,Eros,414000,0,2013,414000
phata poster nikla hero,Eros,411000,0,2013,411000
the armstrong lie,SPC,383000,0,2013,383000
tai chi hero,WGUSA,35100,347000,2013,382100
at any price,SPC,381000,0,2013,381000
shootout at wadala,Eros,370000,0,2013,370000
gori tere pyaar mein,Relbig.,342000,0,2013,342000
adore,EXCL,319000,0,2013,319000
a bottle in the gaza sea,FM,5900,306000,2013,311900
go goa gone,Eros,298000,0,2013,298000
blancanieves,Cohen,280000,0,2013,280000
himmatwala,UTV,271000,0,2013,271000
great expectations (2013),MSF,259000,0,2013,259000
the silence,MBox,100000,132000,2013,232000
singh saab the great,Eros,226000,0,2013,226000
abcd (any body can dance),UTV,222000,0,2013,222000
arthur newman,Cdgm.,208000,0,2013,208000
ghanchakkar,UTV,203000,0,2013,203000
midnight's children,P/108,190000,0,2013,190000
r... rajkumar,Eros,167000,0,2013,167000
we steal secrets: the story of wikileaks,FCW,166000,0,2013,166000
the patience stone,SPC,149000,0,2013,149000
rangeelay,Eros,148000,0,2013,148000
drug war,Vari.,128000,0,2013,128000
beyond the hills,IFC,125000,0,2013,125000
storm surfers 3d,XL,117000,0,2013,117000
yossi,Strand,117000,0,2013,117000
spinning plates,TFA,112000,0,2013,112000
ek thi daayan,Eros,112000,0,2013,112000
the english teacher,Cdgm.,105000,0,2013,105000
man of tai chi,RTWC,100000,0,2013,100000
passion,EOne,92200,0,2013,92200
byzantium,IFC,89200,0,2013,89200
the rooftop,WGUSA,85800,0,2013,85800
we are what we are,EOne,81400,0,2013,81400
stuck in love,MNE,81100,0,2013,81100
more than honey,KL,79800,0,2013,79800
caesar must die,AF,76900,0,2013,76900
leviathan (2013),CGld,76200,0,2013,76200
no one lives,Anch.,74900,0,2013,74900
war witch,Trib.,70500,0,2013,70500
the pervert's guide to ideology,Zeit.,68000,0,2013,68000
my lucky star,CL,64400,0,2013,64400
becoming traviata,Distrib.,62700,0,2013,62700
sightseers,IFC,61800,0,2013,61800
the canyons,IFC,56800,0,2013,56800
table no. 21,Eros,46700,0,2013,46700
wish you were here (2013),EOne,46300,0,2013,46300
a glimpse inside the mind of charles swan iii,A24,45400,0,2013,45400
the we and the i,P/108,42200,0,2013,42200
killing season,MNE,39900,0,2013,39900
post tenebras lux,Strand,39200,0,2013,39200
rising from ashes,FRun,38600,0,2013,38600
berberian sound studio,IFC,38500,0,2013,38500
ip man: the final fight,WGUSA,37900,0,2013,37900
redemption (2013),RAtt.,36900,0,2013,36900
camille claudel 1915,KL,35300,0,2013,35300
bastards,IFC,24500,0,2013,24500
paradise: love,Strand,24300,0,2013,24300
our children,Distrib.,23200,0,2013,23200
v/h/s/2,Magn.,21800,0,2013,21800
the look of love,IFC,21300,0,2013,21300
the painting (2013),GK,21000,0,2013,21000
terraferma,Cohen,20000,0,2013,20000
love and honor (2013),IFC,19700,0,2013,19700
nostalghia,KL,18800,0,2013,18800
casting by,SD,18200,0,2013,18200
violet & daisy,Cdgm.,17200,0,2013,17200
jayne mansfield's car,Anch.,14800,0,2013,14800
a wedding invitation,CJ,14400,0,2013,14400
red obsession,A23,13200,0,2013,13200
the selfish giant,IFC,12200,0,2013,12200
charlie countryman,MNE,11700,0,2013,11700
just like a woman,Cohen,11400,0,2013,11400
so young,CL,11200,0,2013,11200
in the name of,FM,9900,0,2013,9900
inchallah (u.s. only),EOne,9800,0,2013,9800
welcome to the punch,IFC,9700,0,2013,9700
clandestine childhood,IFC,9000,0,2013,9000
argento's dracula 3d,IFC,8100,0,2013,8100
finding mr. right,CL,6900,0,2013,6900
paradise: hope,Strand,6700,0,2013,6700
paradise: faith,Strand,6500,0,2013,6500
the guillotines,WGUSA,5300,0,2013,5300
the stroller strategy,Rialto,3500,0,2013,3500
what richard did,Trib.,2700,0,2013,2700
caught in the web,Vita.,1100,0,2013,1100
i spit on your grave 2,Anch.,800,0,2013,800
into the white,Magn.,700,0,2013,700
storage 24,Magn.,100,0,2013,100
transformers: age of extinction,Par.,245400000,858600000,2014,1104000000
the hobbit: the battle of the five armies,WB (NL),255100000,700900000,2014,956000000
guardians of the galaxy,BV,333200000,440200000,2014,773400000
maleficent,BV,241400000,517100000,2014,758500000
the hunger games: mockingjay - part 1,LGF,337100000,418200000,2014,755300000
x-men: days of future past,Fox,233900000,513900000,2014,747800000
captain america: the winter soldier,BV,259800000,454500000,2014,714300000
dawn of the planet of the apes,Fox,208500000,502100000,2014,710600000
the amazing spider-man 2,Sony,202900000,506100000,2014,709000000
interstellar,Par.,188000000,489400000,2014,677400000
big hero 6,BV,222500000,435300000,2014,657800000
how to train your dragon 2,Fox,177000000,444500000,2014,621500000
american sniper,WB,350100000,197300000,2014,547400000
godzilla (2014),WB,200700000,328400000,2014,529100000
rio 2,Fox,131500000,368600000,2014,500100000
teenage mutant ninja turtles (2014),Par.,191200000,302100000,2014,493300000
the lego movie,WB,257800000,211400000,2014,469200000
lucy,Uni.,126700000,336700000,2014,463400000
penguins of madagascar,Fox,83400000,289700000,2014,373100000
edge of tomorrow,WB,100200000,270300000,2014,370500000
gone girl,Fox,167800000,201600000,2014,369400000
night at the museum: secret of the tomb,Fox,113700000,249500000,2014,363200000
noah,Par.,101200000,261399999,2014,362599999
the maze runner,Fox,102400000,245900000,2014,348300000
300: rise of an empire,WB,106600000,231000000,2014,337600000
22 jump street,Sony,191700000,139600000,2014,331300000
the fault in our stars,Fox,124900000,182300000,2014,307200000
divergent,LG/S,150900000,137900000,2014,288800000
mr. peabody & sherman,Fox,111500000,164200000,2014,275700000
neighbors,Uni.,150200000,120500000,2014,270700000
exodus: gods and kings,Fox,65000000,203200000,2014,268200000
annabelle,WB (NL),84300000,172800000,2014,257100000
hercules (2014),Par.,72700000,172100000,2014,244800000
robocop (2014),Sony,58600000,184100000,2014,242700000
the imitation game,Wein.,91100000,142400000,2014,233500000
non-stop,Uni.,92200000,130600000,2014,222800000
dracula untold,Uni.,56300000,160800000,2014,217100000
the expendables 3,LGF,39300000,175300000,2014,214600000
into the woods,BV,128000000,85100000,2014,213100000
fury (2014),Sony,85800000,126000000,2014,211800000
journey to the west,Magn.,18100,205600000,2014,205618100
need for speed,BV,43600000,159700000,2014,203300000
the other woman (2014),Fox,83900000,112800000,2014,196700000
the equalizer,Sony,101500000,90800000,2014,192300000
breakup buddies,CL,778000,188200000,2014,188978000
the grand budapest hotel,FoxS,59300000,115500000,2014,174800000
dumb and dumber to,Uni.,86200000,83600000,2014,169800000
unbroken,Uni.,115600000,47800000,2014,163400000
into the storm,WB (NL),47600000,114100000,2014,161700000
the monuments men,Sony,78000000,77000000,2014,155000000
ride along,Uni.,134900000,19500000,2014,154400000
planes: fire & rescue,BV,59200000,92200000,2014,151400000
let's be cops,Fox,82400000,55800000,2014,138200000
jack ryan: shadow recruit,Par.,50600000,84900000,2014,135500000
annie (2014),Sony,85900000,47900000,2014,133800000
blended,WB,46300000,81700000,2014,128000000
sex tape,Sony,38500000,87500000,2014,126000000
the theory of everything,Focus,35900000,87800000,2014,123700000
the nut job,ORF,64300000,56600000,2014,120900000
the wind rises,BV,5200000,112700000,2014,117900000
pompeii,TriS,23200000,94600000,2014,117800000
the admiral: roaring currents,CJ,2600000,109600000,2014,112200000
the purge: anarchy,Uni.,72000000,40000000,2014,112000000
the boxtrolls,Focus,50800000,58400000,2014,109200000
horrible bosses 2,WB,54400000,53200000,2014,107600000
ouija,Uni.,50900000,52700000,2014,103600000
birdman,FoxS,42300000,60900000,2014,103200000
transcendence,WB,23000000,80000000,2014,103000000
"alexander and the terrible, horrible, no good, very bad day",BV,67000000,34400000,2014,101400000
heaven is for real,TriS,91400000,9900000,2014,101300000
tammy,WB (NL),84500000,16000000,2014,100500000
p.k.,UTV,10600000,89800000,2014,100400000
the book of life (2014),Fox,50200000,49600000,2014,99800000
paranormal activity: the marked ones,Par.,32500000,58400000,2014,90900000
the hundred-foot journey,BV,54200000,34600000,2014,88800000
john wick,LG/S,43000000,45700000,2014,88700000
deliver us from evil,SGem,30600000,57400000,2014,88000000
a million ways to die in the west,Uni.,43100000,44100000,2014,87200000
snowpiercer,RTWC,4600000,82200000,2014,86800000
step up all in,LG/S,14900000,71300000,2014,86200000
the judge,WB,47100000,37300000,2014,84400000
muppets most wanted,BV,51200000,29200000,2014,80400000
if i stay,WB (NL),50500000,28400000,2014,78900000
"i, frankenstein",LGF,19100000,52100000,2014,71200000
the attorney,WGUSA,557000,70000000,2014,70557000
think like a man too,SGem,65200000,5000000,2014,70200000
brick mansions,Rela.,20400000,48500000,2014,68900000
stalingrad (2014),Sony,1000000,67099999,2014,68099999
son of god,Fox,59700000,8100000,2014,67800000
jersey boys,WB,47000000,20600000,2014,67600000
the giver,Wein.,45100000,21900000,2014,67000000
selma,Par.,52100000,14700000,2014,66800000
god's not dead,Free,60800000,3900000,2014,64700000
thunder and the house of magic!,Shout!,4100,64200000,2014,64204100
begin again,Wein.,16200000,47300000,2014,63500000
the legend of hercules,LG/S,18800000,42400000,2014,61200000
evangelion: 3.0 you can (not) redo,Elev.,175000,60300000,2014,60475000
dolphin tale 2,WB,42000000,15800000,2014,57800000
st. vincent,Wein.,44100000,10700000,2014,54800000
no good deed (2014),SGem,52500000,1800000,2014,54300000
a walk among the tombstones,Uni.,26300000,26900000,2014,53200000
3 days to kill,Rela.,30700000,21900000,2014,52600000
wild (2014),FoxS,37900000,14600000,2014,52500000
magic in the moonlight,SPC,10500000,40500000,2014,51000000
dragon ball z: battle of gods,SV,2600000,47800000,2014,50400000
about last night (2014),SGem,48600000,365000,2014,48965000
whiplash,SPC,13100000,35900000,2014,49000000
chef,ORF,31400000,14500000,2014,45900000
earth to echo,Rela.,38900000,6400000,2014,45300000
boyhood,IFC,25400000,19100000,2014,44500000
oculus,Rela.,27700000,16300000,2014,44000000
bang bang,FIP,2500000,39500000,2014,42000000
as above/so below,Uni.,21300000,20600000,2014,41900000
this is where i leave you,WB,34300000,7000000,2014,41300000
that awkward moment,Focus,26100000,14400000,2014,40500000
frank miller's sin city: a dame to kill for,W/Dim.,13800000,25600000,2014,39400000
the gambler,Par.,33700000,5600000,2014,39300000
million dollar arm,BV,36500000,2800000,2014,39300000
nightcrawler,ORF,32400000,6300000,2014,38700000
devil's due,Fox,15800000,21100000,2014,36900000
a most wanted man,RAtt.,17200000,19000000,2014,36200000
the best of me,Rela.,26800000,9200000,2014,36000000
endless love (2014),Uni.,23400000,11300000,2014,34700000
get on up,Uni.,30700000,2700000,2014,33400000
the november man,Rela.,25000000,7500000,2014,32500000
the pirates,WGUSA,416000,32100000,2014,32516000
winter's tale,WB,12600000,18500000,2014,31100000
when the game stands tall,TriS,30100000,0,2014,30100000
draft day,LG/S,28800000,620000,2014,29420000
big eyes,Wein.,14500000,14800000,2014,29300000
the divine move,CJ,137000,27800000,2014,27937000
top five,Par.,25300000,800000,2014,26100000
iceman (2014),WGUSA,7700,26000000,2014,26007700
and so it goes,CE,15200000,10200000,2014,25400000
on the other side of the tracks,Wein.,9600,25100000,2014,25109600
the players,Wein.,10900,24600000,2014,24610900
the tale of the princess kaguya,GK,703000,23500000,2014,24203000
a haunted house 2,ORF,17300000,6600000,2014,23900000
the railway man,Wein.,4400000,17900000,2014,22300000
mr. turner,SPC,4000000,18200000,2014,22200000
the suspect (2014),WGUSA,219000,21400000,2014,21619000
bears,BV,17800000,3500000,2014,21300000
yves saint laurent,Wein.,724000,20300000,2014,21024000
labor day,Par.,13400000,6900000,2014,20300000
"like father, like son (2014)",IFC,335000,19600000,2014,19935000
left behind (2014),Free,14000000,5700000,2014,19700000
legends of oz: dorothy's return,CE,8500000,10200000,2014,18700000
the drop,FoxS,10700000,7900000,2014,18600000
the quiet ones,LGF,8500000,9300000,2014,17800000
sabotage (2014),ORF,10500000,7000000,2014,17500000
addicted,LGF,17400000,0,2014,17400000
road to ninja - naruto the movie,Elev.,43200,17300000,2014,17343200
calvary,FoxS,3600000,13300000,2014,16900000
the pyramid,Fox,2800000,14100000,2014,16900000
tyler perry's the single moms club,LGF,16000000,364000,2014,16364000
beyond outrage,Magn.,3900,16200000,2014,16203900
before i go to sleep,CE,3200000,12200000,2014,15400000
vampire academy,Wein.,7800000,7600000,2014,15400000
inherent vice,WB,8100000,6600000,2014,14700000
island of lemurs: madagascar (imax),WB,11300000,2800000,2014,14100000
the two faces of january,Magn.,507000,13000000,2014,13507000
fading gigolo,MNE,3800000,9600000,2014,13400000
foxcatcher,SPC,12100000,0,2014,12100000
a most violent year,A24,5700000,6300000,2014,12000000
the interview (2014),Sony,6100000,5200000,2014,11300000
one chance,Wein.,101000,10800000,2014,10901000
bicycling with moliere,Strand,59900,10700000,2014,10759900
belle,FoxS,10700000,0,2014,10700000
wetlands,Strand,59500,10500000,2014,10559500
moms' night out,TriS,10400000,0,2014,10400000
the babadook,IFC,964000,9300000,2014,10264000
nymphomaniac: volume i,Magn.,786000,9500000,2014,10286000
gladiators of rome,VPD,8200,10100000,2014,10108200
mood indigo,Drft.,303000,9500000,2014,9803000
alan partridge: the movie,Magn.,153000,9600000,2014,9753000
venus in fur,IFC,374000,8000000,2014,8374000
filth,Magn.,34400,8300000,2014,8334400
what if (2014),CBS,3500000,4400000,2014,7900000
finding fanny,FIP,616000,7100000,2014,7716000
pride (2014),CBS,1400000,6100000,2014,7500000
chinese puzzle,Cohen,339000,7100000,2014,7439000
a long way down,Magn.,13300,7200000,2014,7213300
jessabelle,LGF,0,7000000,2014,7000000
"two days, one night",IFC,1400000,5400000,2014,6800000
a letter to momo,GK,71700,6700000,2014,6771700
cantinflas,LGF,6400000,0,2014,6400000
le chef,Cohen,343000,5900000,2014,6243000
mas negro que la noche,LGF,870000,5200000,2014,6070000
french gigolo (cliente),IFC,3000,6000000,2014,6003000
the trip to italy,IFC,2900000,3000000,2014,5900000
the immigrant,Wein.,2000000,3800000,2014,5800000
wish i was here,Focus,3600000,1900000,2014,5500000
under the skin (2014),A24,2600000,2800000,2014,5400000
the skeleton twins,RAtt.,5300000,0,2014,5300000
the french minister,IFC,12000,5100000,2014,5112000
ernest & celestine,GK,262000,4800000,2014,5062000
tracks (2014),Wein.,510000,4400000,2014,4910000
the love punch,KE,267000,4500000,2014,4767000
dear white people,RAtt.,4400000,0,2014,4400000
the lunchbox,SPC,4200000,0,2014,4200000
my old lady,Cohen,4000000,0,2014,4000000
diplomacy,Zeit.,231000,3700000,2014,3931000
horns,RTWC,174000,3700000,2014,3874000
ida,MBox,3800000,0,2014,3800000
14 blades,RTWC,0,3800000,2014,3800000
ragnarok,Magn.,1400,3700000,2014,3701400
veronica mars,WB,3300000,195000,2014,3495000
mommy,RAtt.,3500000,0,2014,3500000
jack and the cuckoo-clock heart,Shout!,0,3400000,2014,3400000
the grand seduction,EOne,3400000,0,2014,3400000
enemy,A24,1000000,2400000,2014,3400000
words and pictures,RAtt.,2200000,1200000,2014,3400000
the protector 2,Magn.,2500,3300000,2014,3302500
the rover,A24,1100000,2100000,2014,3200000
the mystery of happiness,Strand,8500,3200000,2014,3208500
rosewater,ORF,3100000,0,2014,3100000
obvious child,A24,3100000,0,2014,3100000
the german doctor,Gold.,418000,2600000,2014,3018000
citizenfour,RTWC,2800000,202000,2014,3002000
a coffee in berlin,MBox,150000,2600000,2014,2750000
the good lie,WB,2700000,0,2014,2700000
the raid 2,SPC,2600000,0,2014,2600000
living is easy with eyes closed,Outs,11600,2600000,2014,2611600
a five star life,MBox,307000,2200000,2014,2507000
kick,UTV,2500000,0,2014,2500000
kill the messenger,Focus,2500000,0,2014,2500000
the homesman,Saban,2400000,0,2014,2400000
blood ties (2014),RAtt.,42500,2400000,2014,2442500
the guest (2014),PH,333000,2000000,2014,2333000
life of riley,KL,11600,2300000,2014,2311600
ode to my father,CJ,2300000,0,2014,2300000
love is strange,SPC,2300000,0,2014,2300000
marius,KL,9800,2200000,2014,2209800
"men, women & children",Par.,706000,1500000,2014,2206000
2 states,UTV,2200000,0,2014,2200000
nymphomaniac: volume ii,Magn.,327000,1900000,2014,2227000
le week-end,MBox,2200000,0,2014,2200000
gloria (2014),RAtt.,2100000,0,2014,2100000
"20,000 days on earth",Drft.,280000,1800000,2014,2080000
only lovers left alive,SPC,1900000,0,2014,1900000
tusk,A24,1800000,0,2014,1800000
awake: the life of yogananda,CF&SR,1500000,0,2014,1500000
fed up,RTWC,1500000,0,2014,1500000
finding vivian maier,IFC,1500000,0,2014,1500000
make your move,HTR,125000,1300000,2014,1425000
bright days ahead,Trib.,21800,1400000,2014,1421800
locke,A24,1400000,0,2014,1400000
force majeure,Magn.,1400000,0,2014,1400000
postman pat: the movie,Shout!,1500,1300000,2014,1301500
just a sigh,Distrib.,75500,1200000,2014,1275500
jai ho,Eros,1300000,0,2014,1300000
for a woman,FM,32299,1200000,2014,1232299
singham returns,Eros,1200000,0,2014,1200000
why don't you play in hell,Drft.,28500,1200000,2014,1228500
the remaining,Triu,1200000,0,2014,1200000
the way he looks,Strand,101000,1100000,2014,1201000
ilo ilo,FM,56800,1100000,2014,1156800
hector and the search for happiness,Rela.,1100000,0,2014,1100000
leviathan (2014),SPC,1100000,0,2014,1100000
the captive,A24,1100000,0,2014,1100000
laggies,A24,1100000,0,2014,1100000
jackpot,DR,800,1100000,2014,1100800
lila lila,Crnth,0,1100000,2014,1100000
haider,UTV,1000000,0,2014,1000000
third person,SPC,1000000,0,2014,1000000
borgman,Drft.,57500,952000,2014,1009500
the disappearance of eleanor rigby,Wein.,588000,397000,2014,985000
shaadi ke side effects,Eros,921000,0,2014,921000
song of the sea,GK,858000,0,2014,858000
kochadaiiyaan,Eros,817000,0,2014,817000
age of uprising: the legend of michael kohlhaas (u.s. only),MBox,3300,797000,2014,800300
the zero theorem,Ampl.,258000,513000,2014,771000
palo alto,Trib.,768000,0,2014,768000
ek villain,Eros,731000,0,2014,731000
khoobsurat,UTV,711000,0,2014,711000
holiday (2014),Relbig.,707000,0,2014,707000
hasee toh phasee,Relbig.,646000,0,2014,646000
frank,Magn.,645000,0,2014,645000
mary kom,Eros,621000,0,2014,621000
the signal (2014),Focus,601000,0,2014,601000
back in time (congcong nanian),CL,569000,0,2014,569000
highway (2014),UTV,529000,0,2014,529000
dom hemingway,FoxS,524000,0,2014,524000
the one i love,RTWC,513000,0,2014,513000
archipelago,KL,7800,492000,2014,499800
a girl walks home alone at night,KL,492000,0,2014,492000
the congress,Drft.,138000,318000,2014,456000
in secret,RAtt.,444000,0,2014,444000
bjork - biophilia live,CP,128000,306000,2014,434000
but always (yi sheng yi shi),CL,431000,0,2014,431000
beijing love story,CL,428000,0,2014,428000
goodbye to language,KL,390000,0,2014,390000
humpty sharma ki dulhania,Relbig.,380000,0,2014,380000
women who flirt (sajiao nvren),CL,375000,0,2014,375000
joe (2014),RAtt.,373000,0,2014,373000
omar,AF,356000,0,2014,356000
the face of love,IFC,350000,0,2014,350000
jimi: all is by my side,XL,341000,0,2014,341000
i origins,FoxS,336000,0,2014,336000
the last sentence,MBox,62500,265000,2014,327500
on my way,Cohen,317000,0,2014,317000
happy ending,Eros,314000,0,2014,314000
i am eleven,Proud,310000,0,2014,310000
7 boxes,BGP,38100,267000,2014,305100
the dance of reality,Abk.,294000,0,2014,294000
elsa & fred (2014),MNE,286000,0,2014,286000
main tera hero,Eros,275000,0,2014,275000
night moves,Cdgm.,272000,0,2014,272000
love on the cloud (wei ai),CL,272000,0,2014,272000
life of crime,RAtt.,265000,0,2014,265000
the green prince,MBox,258000,0,2014,258000
action jackson (2014),Eros,257000,0,2014,257000
the blue room,IFC,255000,0,2014,255000
tazza: the hidden card,CJ,252000,0,2014,252000
james cameron's deepsea challenge 3d,DLA,236000,0,2014,236000
gabrielle (2014),EOne,5500,222000,2014,227500
the breakup guru,CL,209000,0,2014,209000
bethlehem,AF,202000,0,2014,202000
the double (2014),Magn.,200000,0,2014,200000
listen up philip,Trib.,200000,0,2014,200000
we are the best!,Magn.,181000,0,2014,181000
that demon within,CL,172000,0,2014,172000
god's pocket,IFC,170000,0,2014,170000
unrelated,KL,4500,154000,2014,158500
the polar express (2014 re-issue),WB,139000,0,2014,139000
may in the summer,Cohen,22000,112000,2014,134000
the jewish cardinal,FM,134000,0,2014,134000
zero motivation,Zeit.,116000,0,2014,116000
life's a breeze,Magn.,3500,99700,2014,103200
the golden era,CL,103000,0,2014,103000
god help the girl,Ampl.,103000,0,2014,103000
the best offer,IFC,100000,0,2014,100000
child's pose,Zeit.,97200,0,2014,97200
cuban fury,EOne,92400,0,2014,92400
girl on a bicycle,Mont.,91400,0,2014,91400
breathe in,Cohen,89700,0,2014,89700
life after beth,A24,88300,0,2014,88300
advanced style,B360,87900,0,2014,87900
better living through chemistry,Gold.,75100,0,2014,75100
for no good reason,SPC,67400,0,2014,67400
the notebook (2014),SPC,66600,0,2014,66600
heropanti,UTV,63600,0,2014,63600
no tears for the dead,CJ,63100,0,2014,63100
young and beautiful,IFC,61100,0,2014,61100
siddharth,Zeit.,60500,0,2014,60500
walk of shame,FCW,59200,0,2014,59200
the conformist (2014 re-release),KL,58700,0,2014,58700
rudderless,Gold.,58300,0,2014,58300
the rocket (2014),KL,56800,0,2014,56800
in bloom,BWP,56100,0,2014,56100
starred up,Trib.,54900,0,2014,54900
half of a yellow sun,Mont.,54500,0,2014,54500
hateship loveship,IFC,54000,0,2014,54000
"1,000 times good night",FM,53900,0,2014,53900
the missing picture,Strand,52200,0,2014,52200
decoding annie parker,EOne,48400,0,2014,48400
alphaville (2013 re-release),Rialto,47700,0,2014,47700
return to the hiding place,SEA,45400,0,2014,45400
policeman,Crnth,11300,27000,2014,38300
white bird in a blizzard,Magn.,33800,0,2014,33800
the hero of color city,Magn.,32200,0,2014,32200
bird people,IFC,32100,0,2014,32100
closed curtain,Vari.,28100,0,2014,28100
lilting,Strand,27100,0,2014,27100
adult world,IFC,25400,0,2014,25400
a tale of winter (conte d'hiver),BWP,23300,0,2014,23300
the decent one,KL,21300,0,2014,21300
guardian angel,RME,19500,0,2014,19500
tasting menu,Magn.,18700,0,2014,18700
two night stand,EOne,18600,0,2014,18600
burning bush,KL,16700,0,2014,16700
horses of god,KL,14800,0,2014,14800
13 sins,RTWC,13800,0,2014,13800
camp x-ray,IFC,13300,0,2014,13300
special id,WGUSA,12700,0,2014,12700
wolves,KE,12100,0,2014,12100
falcon rising,Free,11800,0,2014,11800
you're not you,EOne,11500,0,2014,11500
the amazing catfish,Strand,11300,0,2014,11300
stray dogs,CGld,10400,0,2014,10400
canopy,Mont.,8500,0,2014,8500
love is in the air,FCW,8400,0,2014,8400
empty hours,Strand,8200,0,2014,8200
rigor mortis,WGUSA,7900,0,2014,7900
the little bedroom,CLS,7400,0,2014,7400
very good girls,WGUSA,6900,0,2014,6900
pioneer,Magn.,6900,0,2014,6900
life of a king,MNE,6500,0,2014,6500
the strange little cat,KS,5900,0,2014,5900
"2 autumns, 3 winters",FM,5800,0,2014,5800
the devil's hand,RAtt.,5700,0,2014,5700
anna,VE,4300,0,2014,4300
open windows,Cdgm.,1800,0,2014,1800
mr. pip,Free,1700,0,2014,1700
star wars: the force awakens,BV,936700000,1131,2015,936701131
jurassic world,Uni.,652300000,1019,2015,652301019
furious 7,Uni.,353000000,1163,2015,353001163
avengers: age of ultron,BV,459000000,946400000,2015,1405400000
minions,Uni.,336000000,823400000,2015,1159400000
spectre,Sony,200100000,680600000,2015,880700000
inside out,BV,356500000,501100000,2015,857600000
mission: impossible - rogue nation,Par.,195000000,487700000,2015,682700000
the hunger games: mockingjay - part 2,LGF,281700000,371700000,2015,653400000
the martian,Fox,228400000,401700000,2015,630100000
fifty shades of grey,Uni.,166200000,404800000,2015,571000000
cinderella (2015),BV,201200000,342400000,2015,543600000
the revenant,Fox,183600000,349300000,2015,532900000
ant-man,BV,180200000,339100000,2015,519300000
hotel transylvania 2,Sony,169700000,305100000,2015,474800000
san andreas,WB (NL),155200000,318800000,2015,474000000
terminator: genisys,Par.,89800000,350800000,2015,440600000
kingsman: the secret service,Fox,128300000,286100000,2015,414400000
home (2015),Fox,177400000,208600000,2015,386000000
mad max: fury road,WB,153600000,224800000,2015,378400000
the good dinosaur,BV,123100000,209100000,2015,332200000
taken 3,Fox,89300000,237200000,2015,326500000
the spongebob movie: sponge out of water,Par.,163000000,162200000,2015,325200000
maze runner: the scorch trials,Fox,81700000,230600000,2015,312300000
the divergent series: insurgent,LG/S,130199999,167100000,2015,297299999
pitch perfect 2,Uni.,184300000,103200000,2015,287500000
paddington,W/Dim.,76300000,191800000,2015,268100000
mojin: the lost legend,WGUSA,1200000,258100000,2015,259300000
lost in hong kong,WGUSA,1300000,255000000,2015,256300000
the peanuts movie,Fox,130199999,116100000,2015,246299999
pixels,Sony,78700000,166100000,2015,244800000
daddy's home,Par.,150400000,92400000,2015,242800000
spy,Fox,110800000,124800000,2015,235600000
alvin and the chipmunks: the road chip,Fox,85900000,148900000,2015,234800000
goodbye mr. loser,CL,1300000,226800000,2015,228100000
ted 2,Uni.,81500000,135200000,2015,216700000
tomorrowland,BV,93400000,115700000,2015,209100000
everest (2015),Uni.,43500000,159900000,2015,203400000
straight outta compton,Uni.,161200000,40400000,2015,201600000
the intern,WB,75800000,118800000,2015,194600000
jupiter ascending,WB,47400000,136600000,2015,184000000
creed,WB (NL),109800000,63800000,2015,173600000
fantastic four,Fox,56100000,111900000,2015,168000000
bridge of spies,BV,72300000,93200000,2015,165500000
focus (2015),WB,53900000,105200000,2015,159100000
the hateful eight,Wein.,54100000,101600000,2015,155700000
goosebumps,Sony,80100000,70100000,2015,150200000
the last witch hunter,LG/S,27400000,119600000,2015,147000000
the taking of tiger mountain,WGUSA,229000,141400000,2015,141629000
trainwreck,Uni.,110200000,30600000,2015,140800000
mr. six,CL,1400000,137800000,2015,139200000
point break (2015),WB,28800000,104900000,2015,133700000
the big short,Par.,70300000,63200000,2015,133500000
pan,WB,35100000,93300000,2015,128400000
wolf totem,Sony,211000,125600000,2015,125811000
magic mike xxl,WB,66000000,56500000,2015,122500000
dragon blade,LGP,74100,121500000,2015,121574100
seventh son,Uni.,17200000,97000000,2015,114200000
insidious chapter 3,Focus,52200000,60800000,2015,113000000
get hard,WB,90400000,21400000,2015,111800000
the man from u.n.c.l.e.,WB,45400000,64400000,2015,109800000
paul blart: mall cop 2,Sony,71000000,36600000,2015,107600000
shaun the sheep movie,LGF,19400000,86800000,2015,106200000
sisters,Uni.,87000000,18000000,2015,105000000
vacation,WB (NL),58900000,46000000,2015,104900000
chappie,Sony,31600000,70500000,2015,102100000
joy,Fox,56500000,44700000,2015,101200000
black mass,WB,62600000,37200000,2015,99800000
devil and angel (e gun tian shi),CL,131000,98500000,2015,98631000
the visit,Uni.,65200000,33200000,2015,98400000
spotlight,ORF,45100000,53200000,2015,98300000
poltergeist (2015),Fox,47400000,48000000,2015,95400000
in the heart of the sea,WB,25000000,68900000,2015,93900000
southpaw,Wein.,52400000,39500000,2015,91900000
the second best exotic marigold hotel,FoxS,33100000,52900000,2015,86000000
paper towns,Fox,32000000,53500000,2015,85500000
sicario,LGF,46900000,38000000,2015,84900000
hitman: agent 47,Fox,22500000,59900000,2015,82400000
the wedding ringer,SGem,64500000,15300000,2015,79800000
paranormal activity: the ghost dimension,Par.,18300000,60600000,2015,78900000
crimson peak,Uni.,31100000,43600000,2015,74700000
the transporter refueled,EC,16000000,56600000,2015,72600000
run all night,WB,26500000,45200000,2015,71700000
war room,TriS,67800000,0,2015,67800000
the age of adaline,LGF,42600000,23000000,2015,65600000
the danish girl,Focus,11100000,53100000,2015,64200000
unfriended,Uni.,32500000,31600000,2015,64100000
the longest ride,Fox,37400000,25500000,2015,62900000
brooklyn,FoxS,38300000,23800000,2015,62100000
dragon ball z: resurrection 'f',FUN,8000000,53800000,2015,61800000
woman in gold,Wein.,33299999,28300000,2015,61599999
krampus,Uni.,42700000,18800000,2015,61500000
the walk,TriS,10100000,51000000,2015,61100000
the perfect guy,SGem,57000000,3200000,2015,60200000
the gift (2015),STX,43800000,15200000,2015,59000000
no escape,Wein.,27300000,27100000,2015,54400000
sinister 2,Focus,27700000,25100000,2015,52800000
prem ratan dhan payo,FIP,4400000,48200000,2015,52600000
the boy next door,Uni.,35400000,17000000,2015,52400000
the night before,Sony,43000000,9300000,2015,52300000
hot pursuit,WB (NL),34600000,17100000,2015,51700000
the 100-year old man who climbed out the window and disappeared,MBox,944000,50200000,2015,51144000
the himalayas,CJ,697000,49800000,2015,50497000
surprise - journey to the west,AR,0,49600000,2015,49600000
entourage,WB,32400000,16900000,2015,49300000
the woman in black 2: angel of death,Rela.,26500000,22400000,2015,48900000
concussion (2015),Sony,34500000,14100000,2015,48600000
mortdecai,LGF,7700000,39600000,2015,47300000
coming home (2015),SPC,378000,46400000,2015,46778000
"mcfarland, usa",BV,44500000,1200000,2015,45700000
max (2015),WB,42700000,1300000,2015,44000000
still alice,SPC,18800000,25100000,2015,43900000
the duff,LGF,34000000,9500000,2015,43500000
legend,Uni.,1900000,41100000,2015,43000000
the gallows,WB (NL),22800000,20200000,2015,43000000
love the coopers,LGF,26300000,16100000,2015,42400000
the lady in the van,SPC,10000000,31400000,2015,41400000
ricki and the flash,TriS,26800000,14500000,2015,41300000
carol,Wein.,12700000,27600000,2015,40300000
the lazarus effect,Rela.,25800000,12600000,2015,38400000
the water diviner,WB,4200000,34000000,2015,38200000
a walk in the woods,BG,29500000,8000000,2015,37500000
ex machina,A24,25400000,11400000,2015,36800000
burnt,Wein.,13700000,23000000,2015,36700000
room,A24,14700000,20700000,2015,35400000
the secret in their eyes (2015),STX,20200000,14700000,2015,34900000
steve jobs,Uni.,17800000,16700000,2015,34500000
victor frankenstein,Fox,5800000,28500000,2015,34300000
project almanac,Par.,22300000,10900000,2015,33200000
self/less,Focus,12300000,18200000,2015,30500000
far from the madding crowd,FoxS,12200000,18000000,2015,30200000
mr. holmes,RAtt.,17700000,11600000,2015,29300000
love & mercy,RAtt.,12600000,16100000,2015,28700000
irrational man,SPC,4000000,23400000,2015,27400000
american ultra,LGF,14400000,12700000,2015,27100000
wild tales,SPC,3100000,23900000,2015,27000000
aloha,Sony,21100000,5200000,2015,26300000
"love, rosie",TFA,20400,25600000,2015,25620400
the 33,WB,12200000,12700000,2015,24900000
capture the flag,Par.,6700,24600000,2015,24606700
the gunman,ORF,10700000,13500000,2015,24200000
go away mr. tumor,CL,287000,21500000,2015,21787000
black or white,Rela.,21600000,0,2015,21600000
blackhat,Uni.,8000000,11600000,2015,19600000
dope,ORF,17500000,480000,2015,17980000
brothers: blood against blood,FIP,614000,17200000,2015,17814000
while we're young,A24,7600000,9700000,2015,17300000
monkey kingdom,BV,16399999,711000,2015,17110999
macbeth (2015),Wein.,1100000,15200000,2015,16300000
scouts guide to the zombie apocalypse,Par.,3700000,12400000,2015,16100000
suffragette,Focus,4700000,11300000,2015,16000000
it follows,RTWC,14700000,0,2015,14700000
unfinished business,Fox,10200000,4200000,2015,14400000
do you believe?,PFR,13000000,1400000,2015,14400000
woodlawn,PFR,14400000,0,2015,14400000
strange magic,BV,12400000,1200000,2015,13600000
hot tub time machine 2,Par.,12300000,767000,2015,13067000
child 44,LG/S,1200000,11700000,2015,12900000
we are your friends,WB,3600000,7500000,2015,11100000
danny collins,BST,5600000,5200000,2015,10800000
kung fu killer,WGUSA,130000,10000000,2015,10130000
a little chaos,FCW,558000,9500000,2015,10058000
the loft,ORF,6000000,4099999,2015,10099999
the young & prodigious t.s. spivet,Wein.,174000,9300000,2015,9474000
shanghai,Wein.,46400,9200000,2015,9246400
un gallo con muchos huevos,LGF,9100000,0,2015,9100000
me and earl and the dying girl,FoxS,6800000,2300000,2015,9100000
amy,A24,8400000,0,2015,8400000
shaandaar,FIP,522000,7800000,2015,8322000
trumbo (2015),BST,7900000,378000,2015,8278000
bajrangi bhaijaan,Eros,8199999,0,2015,8199999
i'll see you in my dreams,BST,7400000,0,2015,7400000
the green inferno,BH Tilt,7200000,0,2015,7200000
grandma (2015),SPC,7000000,107000,2015,7107000
our brand is crisis (2015),WB,7000000,0,2015,7000000
baahubali: the beginning,BSC,6700000,0,2015,6700000
bajirao mastani,Eros,6600000,0,2015,6600000
little boy,ORF,6500000,0,2015,6500000
what we do in the shadows,U/P,3500000,2800000,2015,6300000
anomalisa,Par.,3800000,1900000,2015,5700000
pawn sacrifice,BST,2400000,3100000,2015,5500000
serena,Magn.,176000,4900000,2015,5076000
mr. x,FIP,45000,5000000,2015,5045000
dilwale,UTV,4900000,0,2015,4900000
back to the future day,UHE,1700000,3200000,2015,4900000
trash,FCW,17500,4800000,2015,4817500
true story,FoxS,4700000,0,2015,4700000
"buen dia, ramon",FIP,154000,4500000,2015,4654000
hamari adhuri kahani,FIP,235000,4200000,2015,4435000
45 years,IFC,4200000,0,2015,4200000
escobar: paradise lost,RTWC,196000,3600000,2015,3796000
spare parts,LGF,3600000,0,2015,3600000
learning to drive,BG,3400000,0,2015,3400000
by the sea,Uni.,538000,2800000,2015,3338000
sleeping with other people,IFC,819000,2400000,2015,3219000
phoenix (2015),IFC,3200000,0,2015,3200000
jimmy's hall,SPC,561000,2600000,2015,3161000
dil dhadakne do,Eros,3100000,0,2015,3100000
ladrones,LGF,3100000,0,2015,3100000
remember (canada release),EOne,547000,2500000,2015,3047000
tanu weds manu returns,Eros,3000000,0,2015,3000000
rock the kasbah,ORF,3000000,0,2015,3000000
the end of the tour,A24,3000000,0,2015,3000000
captive (2015),Par.,2600000,218000,2015,2818000
he named me malala,FoxS,2700000,97100,2015,2797100
youth,FoxS,2700000,0,2015,2700000
chi-raq,RAtt.,2700000,0,2015,2700000
truth,SPC,2500000,0,2015,2500000
mistress america,FoxS,2500000,0,2015,2500000
jem and the holograms,Uni.,2200000,149000,2015,2349000
beloved sisters,MBox,54000,2200000,2015,2254000
the riot club,IFC,7700,2100000,2015,2107700
tamasha,UTV,2100000,0,2015,2100000
cake,CLF,2000000,0,2015,2000000
assassination (2015),WGUSA,1900000,0,2015,1900000
clouds of sils maria,IFC,1900000,0,2015,1900000
testament of youth,SPC,1800000,0,2015,1800000
piku,Yash,1800000,0,2015,1800000
the vatican tapes,LGF,1800000,0,2015,1800000
son of saul,SPC,1800000,0,2015,1800000
janis: little girl blue,FR,410000,1200000,2015,1610000
'71,RAtt.,1300000,355000,2015,1655000
the diary of a teenage girl,SPC,1500000,0,2015,1500000
i (2015),AaF,1400000,0,2015,1400000
infinitely polar bear,SPC,1400000,0,2015,1400000
99 homes,BG,1400000,0,2015,1400000
welcome back,Eros,1400000,0,2015,1400000
the salt of the earth,SPC,1300000,0,2015,1300000
maps to the stars,FCW,351000,988000,2015,1339000
iris (2015),Magn.,1300000,0,2015,1300000
the wolfpack,Magn.,1300000,0,2015,1300000
veteran,CJ,1200000,0,2015,1200000
goodnight mommy,RTWC,1200000,0,2015,1200000
black sea,Focus,1200000,0,2015,1200000
miss you already,RAtt.,1200000,0,2015,1200000
where hope grows,RAtt.,1200000,0,2015,1200000
cartel land,Orch.,704000,422000,2015,1126000
timbuktu,Cohen,1100000,0,2015,1100000
dior and i,Orch.,1000000,0,2015,1000000
5 flights up,FCW,1000000,0,2015,1000000
big stone gap,PH,1000000,0,2015,1000000
gett: the trial of viviane amsalem,MBox,988000,0,2015,988000
boruto: naruto the movie,Elev.,920000,0,2015,920000
singh is bling,Eros,919000,0,2015,919000
abcd (any body can dance) 2,UTV,892000,0,2015,892000
mustang,Cohen,845000,0,2015,845000
labyrinth of lies,SPC,794000,0,2015,794000
the d train,IFC,673000,102000,2015,775000
seymour: an introduction,IFC,744000,0,2015,744000
tangerine,Magn.,702000,0,2015,702000
red army,SPC,695000,0,2015,695000
the stanford prison experiment,IFC,661000,0,2015,661000
the assassin,WGUSA,633000,0,2015,633000
"kumiko, the treasure hunter",Ampl.,623000,0,2015,623000
welcome to me,Alc,609000,0,2015,609000
black panthers: vanguard of the revolution,PBS,517000,67200,2015,584200
detective byomkesh bakshy,Yash,579000,0,2015,579000
freeheld,LGF,573000,0,2015,573000
when marnie was there,GK,561000,0,2015,561000
gabbar is back,Eros,535000,0,2015,535000
the last - naruto the movie,Elev.,524000,0,2015,524000
peggy guggenheim art addict,SD,498000,0,2015,498000
phantom (2015),UTV,490000,0,2015,490000
somewhere only we know,CL,482000,0,2015,482000
let's get married,CL,463000,0,2015,463000
bombay velvet,FIP,451000,0,2015,451000
attack on titan: part 1,FUN,450000,0,2015,450000
the third man (2015 re-release),Rialto,449000,0,2015,449000
saint laurent,SPC,429000,0,2015,429000
listen to me marlon,SHO,426000,0,2015,426000
heart of a dog,Abr.,421000,0,2015,421000
the witness (wo shi zheng ren),CL,418000,0,2015,418000
unbranded,Grav.,410000,0,2015,410000
the second mother,Osci.,377000,0,2015,377000
kahlil gibran's the prophet (gathr),Gathr,370000,0,2015,370000
katti batti,UTV,365000,0,2015,365000
kahlil gibran's the prophet,GK,355000,0,2015,355000
effie gray,AF,353000,0,2015,353000
noble,Asp.,347000,0,2015,347000
northern limit line,WGUSA,338000,0,2015,338000
shamitabh,Eros,325000,0,2015,325000
jafar panahi's taxi,KL,322000,0,2015,322000
good kill,IFC,316000,0,2015,316000
running man (2015),CL,311000,0,2015,311000
attack on titan: part 2,FUN,306000,0,2015,306000
theeb,FM,283000,0,2015,283000
white god,Magn.,282000,0,2015,282000
a borrowed identity,Strand,282000,0,2015,282000
in the name of my daughter,Cohen,278000,0,2015,278000
hitchcock/truffaut,Cohen,260000,0,2015,260000
love (2015),Alc,249000,0,2015,249000
tevar,Eros,236000,0,2015,236000
20 once again,CJ,235000,0,2015,235000
slow west,A24,229000,0,2015,229000
a royal night out,ADC,228000,0,2015,228000
a pigeon sat on a branch reflecting on existence,Magn.,223000,0,2015,223000
pyaar ka punchnama 2,Rel.,223000,0,2015,223000
fall in love like a star,CL,213000,0,2015,213000
dark places,A24,209000,0,2015,209000
heneral luna,Abr.,206000,0,2015,206000
gemma bovery,MBox,192000,0,2015,192000
the connection,Drft.,191000,0,2015,191000
love and lost (shi gu),CL,189000,0,2015,189000
stonewall (2015),RAtt.,188000,0,2015,188000
maggie,RAtt.,187000,0,2015,187000
detective k: secret of the lost island,CJ,185000,0,2015,185000
the priests,CJ,185000,0,2015,185000
the farewell party,Gold.,173000,0,2015,173000
a brilliant young mind,Gold.,172000,0,2015,172000
time out of mind,IFC,167000,0,2015,167000
snow girl and the dark crystal,WGUSA,165000,0,2015,165000
c'est si bon,CJ,164000,0,2015,164000
the last women standing,CL,163000,0,2015,163000
5 to 7,IFC,163000,0,2015,163000
after the ball,Free,162000,0,2015,162000
human capital,FM,159000,0,2015,159000
experimenter,Magn.,156000,0,2015,156000
desert dancer,Rela.,155000,0,2015,155000
samba,BG,152000,0,2015,152000
the tribe,Drft.,151000,0,2015,151000
forever young (2015),CL,150000,0,2015,150000
the new girlfriend,Cohen,147000,0,2015,147000
tangerines,Gold.,145000,0,2015,145000
manglehorn,IFC,143000,0,2015,143000
ingrid bergman: in her own words,Rialto,138000,0,2015,138000
twenty (2015),CJ,136000,0,2015,136000
la sapienza,KL,135000,0,2015,135000
mississippi grind,A24,131000,0,2015,131000
a journey through time with anthony,CL,127000,0,2015,127000
boulevard,SM,126000,0,2015,126000
z for zachariah,RAtt.,121000,0,2015,121000
do i sound gay?,IFC,119000,0,2015,119000
love live! the school idol movie,AZ,116000,0,2015,116000
she's funny that way,LGP,112000,0,2015,112000
memories of the sword,WGUSA,111000,0,2015,111000
the look of silence,Drft.,109000,0,2015,109000
the beauty inside,WGUSA,108000,0,2015,108000
the chronicles of evil,CJ,105000,0,2015,105000
every secret thing,SM,104000,0,2015,104000
ghost in the shell: the new movie,FUN,101000,0,2015,101000
black souls (anime nere),Alc,101000,0,2015,101000
a poem is a naked person (2015 re-issue),Jan.,96600,0,2015,96600
saving mr. wu,UEP,92700,0,2015,92700
the tales of hoffmann (2015 re-issue),Rialto,91900,0,2015,91900
christmas eve,Ampl.,91300,0,2015,91300
queen of earth,IFC,91200,0,2015,91200
hero (2015),Eros,88700,0,2015,88700
sunshine superman,Magn.,88100,0,2015,88100
heaven knows what,RTWC,80700,0,2015,80700
nasty baby,Orch.,79800,0,2015,79800
the wonders,Osci.,73400,0,2015,73400
predestination,VE,68400,0,2015,68400
people places things,TFA,67000,0,2015,67000
eden,BG,65500,0,2015,65500
the duke of burgundy,IFC,64500,0,2015,64500
the office,CL,63700,0,2015,63700
flowers,MBox,61600,0,2015,61600
only you,CL,61600,0,2015,61600
girlhood (2015),Strand,60800,0,2015,60800
jauja,CGld,60200,0,2015,60200
gueros,KL,60100,0,2015,60100
i smile back,BG,58700,0,2015,58700
the ark of mr. chow,CL,54100,0,2015,54100
love thy nature,ITL,41100,11800,2015,52900
the advocate: a missing body,CJ,50200,0,2015,50200
heist (2015),LGP,50100,0,2015,50100
difret,TA,49700,0,2015,49700
appropriate behavior,Grav.,46900,0,2015,46900
beyond the reach,RAtt.,45900,0,2015,45900
the salvation,IFC,44900,0,2015,44900
madame bovary,Alc,44200,0,2015,44200
charlie's country,MR,42900,0,2015,42900
pearl button,KL,42200,0,2015,42200
queen and country,BBC,41300,0,2015,41300
the phone,CJ,40500,0,2015,40500
what our fathers did: a nazi legacy,Osci.,40100,0,2015,40100
lila & eve,Gold.,38300,0,2015,38300
before we go,RTWC,37200,0,2015,37200
the mafia only kills in summer,Distrib.,37100,0,2015,37100
knock knock,LGP,36300,0,2015,36300
kindergarten teacher,KL,36200,0,2015,36200
welcome to leith,FRun,36000,0,2015,36000
wild city,WGUSA,34900,0,2015,34900
the forbidden room,KL,34400,0,2015,34400
song one,TFA,32299,0,2015,32299
love forecast,CJ,32200,0,2015,32200
"out 1, noli me tangere",CFilms,31500,0,2015,31500
"3 1/2 minutes, 10 bullets",Part.,30400,0,2015,30400
paulette,Cohen,29500,0,2015,29500
the cut,Strand,28100,0,2015,28100
the keeping room,Drft.,27200,0,2015,27200
big game,EC,24600,0,2015,24600
kill me three times,Magn.,24300,0,2015,24300
"hippocrates, diary of a french doctor",Distrib.,23100,0,2015,23100
court,Zeit.,22900,0,2015,22900
salut d'amour,CJ,22500,0,2015,22500
mediterranea,IFC,22100,0,2015,22100
noma - my perfect storm,Magn.,21100,0,2015,21100
the little death,Magn.,18200,0,2015,18200
gangnam 1970,CJ,18000,0,2015,18000
strangerland,Alc,17500,0,2015,17500
eastern boys,FRun,16800,0,2015,16800
extraction,LGP,16800,0,2015,16800
eva,Wein.,16700,0,2015,16700
the world of kanako,Drft.,16600,0,2015,16600
zombeavers,Free,14900,0,2015,14900
the hallow,IFC,13900,0,2015,13900
amour fou,FM,13700,0,2015,13700
arabian nights: volume 1 - the restless one,KL,12300,0,2015,12300
of horses and men,MBox,11900,0,2015,11900
marie's story,FM,11700,0,2015,11700
1001 grams,KL,11000,0,2015,11000
empire of lust,CJ,10700,0,2015,10700
the forecaster,FOR,10200,0,2015,10200
still life (2015),Trib.,9500,0,2015,9500
every thing will be fine,IFC,9200,0,2015,9200
the lesson,FM,9000,0,2015,9000
an eye for beauty,MR,9000,0,2015,9000
northern soul,Free,8900,0,2015,8900
the girl in the book,Free,8200,0,2015,8200
steak (r)evolution,KL,8000,0,2015,8000
on the way to school,Distrib.,7400,0,2015,7400
hungry hearts,IFC,6900,0,2015,6900
steve mcqueen: the man & le mans,FR,6800,0,2015,6800
arabian nights: volume 2 - the desolate one,KL,6400,0,2015,6400
alleluia,MBox,6300,0,2015,6300
barely lethal,A24,6100,0,2015,6100
chic!,Distrib.,5600,0,2015,5600
far from men,Trib.,5300,0,2015,5300
the dead lands,Magn.,5200,0,2015,5200
jenny's wedding,IFC,4700,0,2015,4700
against the sun,TAFC,4600,0,2015,4600
ashby,TFA,4600,0,2015,4600
arabian nights: volume 3 - the enchanted one,KL,4500,0,2015,4500
the summer of sangaile,Strand,4500,0,2015,4500
club life,Orch.,4400,0,2015,4400
back to the jurassic,CJ,4400,0,2015,4400
in the basement,Strand,3600,0,2015,3600
fidelio: alice's odyssey,FRun,3600,0,2015,3600
that sugar film,Gold.,3500,0,2015,3500
xenia,Strand,3200,0,2015,3200
the iron ministry,Icar.,3200,0,2015,3200
the lady in the car with glasses and a gun,Magn.,2200,0,2015,2200
stations of the cross,FM,1500,0,2015,1500
skin trade,Magn.,1200,0,2015,1200
thanks to my friends,Distrib.,900,0,2015,900
rec 4: apocalypse,Magn.,800,0,2015,800
it's all so quiet (boven is het stil),BWP,700,0,2015,700
tough being loved by jerks,KL,700,0,2015,700
the chambermaid,FM,300,0,2015,300
captain america: civil war,BV,408100000,745200000,2016,1153300000
rogue one: a star wars story,BV,532200000,523900000,2016,1056100000
finding dory,BV,486300000,542300000,2016,1028600000
zootopia,BV,341300000,682500000,2016,1023800000
the jungle book (2016),BV,364000000,602500000,2016,966500000
the secret life of pets,Uni.,368400000,507100000,2016,875500000
batman v superman: dawn of justice,WB,330400000,543300000,2016,873700000
fantastic beasts and where to find them,WB,234000000,580000000,2016,814000000
deadpool,Fox,363100000,420000000,2016,783100000
suicide squad,WB,325100000,421700000,2016,746800000
doctor strange,BV,232600000,445100000,2016,677700000
moana,BV,248800000,394600000,2016,643400000
sing,Uni.,270400000,363800000,2016,634200000
the mermaid (mei ren yu),Sony,3200000,550600000,2016,553800000
x-men: apocalypse,Fox,155400000,388500000,2016,543900000
kung fu panda 3,Fox,143500000,377600000,2016,521100000
la la land,LG/S,151100000,295000000,2016,446100000
warcraft,Uni.,47400000,386300000,2016,433700000
jason bourne,Uni.,162400000,253100000,2016,415500000
ice age: collision course,Fox,64099999,344500000,2016,408599999
independence day: resurgence,Fox,103100000,286500000,2016,389600000
monster hunt,FR,32800,385300000,2016,385332800
the legend of tarzan,WB,126600000,230100000,2016,356700000
the angry birds movie,Sony,107500000,244800000,2016,352300000
trolls,Fox,153700000,193200000,2016,346900000
star trek beyond,Par.,158800000,184600000,2016,343400000
now you see me 2,LG/S,65099999,269800000,2016,334899999
the conjuring 2,WB (NL),102500000,217900000,2016,320400000
passengers (2016),Sony,100000000,203100000,2016,303100000
dangal,UTV,12400000,290500000,2016,302900000
alice through the looking glass,BV,77000000,222400000,2016,299400000
miss peregrine's home for peculiar children,Fox,87200000,209200000,2016,296400000
teenage mutant ninja turtles: out of the shadows,Par.,82100000,163600000,2016,245700000
assassin's creed,Fox,54600000,186300000,2016,240900000
sully,WB,125100000,115700000,2016,240800000
hidden figures,Fox,169600000,66300000,2016,235900000
ghostbusters (2016),Sony,128400000,100800000,2016,229200000
inferno,Sony,34300000,185700000,2016,220000000
central intelligence,WB (NL),127400000,89500000,2016,216900000
bridget jones's baby,Uni.,24300000,187700000,2016,212000000
me before you,WB (NL),56200000,152100000,2016,208300000
london has fallen,Focus,62500000,143200000,2016,205700000
arrival,Par.,100500000,102800000,2016,203300000
the monkey king 2 in 3d,CL,710000,193000000,2016,193710000
bad moms,STX,113300000,70700000,2016,184000000
storks,WB,72700000,110700000,2016,183400000
the bfg,BV,55500000,127900000,2016,183400000
the divergent series: allegiant,LG/S,66200000,113100000,2016,179300000
hacksaw ridge,LGF,67200000,108100000,2016,175300000
the girl on the train (2016),Uni.,75400000,97800000,2016,173200000
operation mekong,WGUSA,800000,172300000,2016,173100000
the huntsman: winter's war,Uni.,48400000,116600000,2016,165000000
the magnificent seven (2016),Sony,93400000,68900000,2016,162300000
jack reacher: never go back,Par.,58700000,103400000,2016,162100000
don't breathe,SGem,89200000,67900000,2016,157100000
ip man 3,WGUSA,2700000,154200000,2016,156900000
the accountant,WB,86300000,68900000,2016,155200000
gods of egypt,LG/S,31200000,119500000,2016,150700000
lights out,WB (NL),67300000,81600000,2016,148900000
pete's dragon (2016),BV,76200000,67500000,2016,143700000
sausage party,Sony,97700000,43000000,2016,140700000
lion,Wein.,51700000,88600000,2016,140300000
detective chinatown (tang ren jie tan an),CL,474000,125400000,2016,125874000
mechanic: resurrection,LG/S,21200000,104500000,2016,125700000
ride along 2,Uni.,91200000,33400000,2016,124600000
deepwater horizon,LG/S,61400000,60400000,2016,121800000
allied,Par.,40100000,79400000,2016,119500000
the shallows,Sony,55100000,64000000,2016,119100000
the purge: election year,Uni.,79200000,39400000,2016,118600000
why him?,Fox,60300000,57800000,2016,118100000
finding mr. right 2,CL,0,114700000,2016,114700000
office christmas party,Par.,54800000,59700000,2016,114500000
how to be single,WB (NL),46800000,65500000,2016,112300000
10 cloverfield lane,Par.,72100000,38100000,2016,110200000
the 5th wave,Sony,34900000,75000000,2016,109900000
neighbors 2: sorority rising,Uni.,55500000,52600000,2016,108100000
cold war 2,WGUSA,561000,102600000,2016,103161000
the little prince,EOne,1300000,96200000,2016,97500000
dirty grandpa,LGF,35600000,58500000,2016,94100000
ben-hur (2016),Par.,26400000,67700000,2016,94100000
money monster,TriS,41000000,52300000,2016,93300000
my big fat greek wedding 2,Uni.,59700000,29200000,2016,88900000
collateral beauty,WB (NL),31000000,57500000,2016,88500000
train to busan,WGUSA,2100000,85400000,2016,87500000
sultan,Yash,6200000,81100000,2016,87300000
war dogs,WB,43000000,43200000,2016,86200000
nerve,LGF,38600000,46700000,2016,85300000
ouija: origin of evil,Uni.,35100000,46600000,2016,81700000
manchester by the sea,RAtt.,47700000,31300000,2016,79000000
the boss,Uni.,63300000,15600000,2016,78900000
shin godzilla,FUN,1900000,76000000,2016,77900000
mike and dave need wedding dates,Fox,46000000,31100000,2016,77100000
boo! a madea halloween,LGF,73200000,1600000,2016,74800000
miracles from heaven,TriS,61700000,12200000,2016,73900000
i am not madame bovary,WGUSA,437000,70400000,2016,70837000
kubo and the two strings,Focus,48000000,21900000,2016,69900000
13 hours: the secret soldiers of benghazi,Par.,52900000,16600000,2016,69500000
moonlight (2016),A24,27900000,37200000,2016,65100000
fences,Par.,57700000,6700000,2016,64400000
the boy (2016),STX,35800000,28400000,2016,64200000
"hail, caesar!",Uni.,30500000,33100000,2016,63600000
the nice guys,WB,36300000,26500000,2016,62800000
l.o.r.d: legend of ravaging dynasties,AR,350000,57700000,2016,58050000
nine lives (2016),EC,19700000,38100000,2016,57800000
zoolander 2,Par.,28800000,27900000,2016,56700000
barbershop: the next cut,WB (NL),54000000,1000000,2016,55000000
the finest hours,BV,27600000,24500000,2016,52100000
master,CJ,597000,51000000,2016,51597000
patriots day,LGF,31900000,18700000,2016,50600000
florence foster jenkins,Par.,27400000,21500000,2016,48900000
mother's day,ORF,32500000,15900000,2016,48400000
luck-key,JBG,467000,47700000,2016,48167000
yo-kai watch: the movie,Elev.,257000,47600000,2016,47857000
a monster calls,Focus,3700000,43600000,2016,47300000
eddie the eagle,Fox,15800000,30400000,2016,46200000
risen,Sony,36900000,9200000,2016,46100000
blair witch,LGF,20800000,24400000,2016,45200000
cafe society,LGF,11100000,32700000,2016,43800000
almost christmas,Uni.,42200000,422000,2016,42622000
the witch,A24,25100000,15300000,2016,40400000
the wild life (2016),LG/S,8000000,31500000,2016,39500000
criminal (2016),LG/S,14700000,24100000,2016,38800000
absolutely fabulous: the movie,FoxS,4800000,33100000,2016,37900000
hell or high water,LGF,27000000,10900000,2016,37900000
the forest,Focus,26600000,11000000,2016,37600000
snowden,ORF,21600000,15700000,2016,37300000
billy lynn's long halftime walk,TriS,1700000,29200000,2016,30900000
when the bough breaks,SGem,29700000,911000,2016,30611000
nocturnal animals,Focus,10700000,19600000,2016,30300000
keeping up with the joneses,Fox,14900000,15000000,2016,29900000
ae dil hai mushkil,FIP,4300000,24100000,2016,28400000
fan,Yash,2300000,25900000,2016,28200000
m.s. dhoni: the untold story,FIP,1800000,26000000,2016,27800000
the light between oceans,BV,12500000,13400000,2016,25900000
the brothers grimsby,Sony,6900000,18300000,2016,25200000
race (2016),Focus,19200000,5900000,2016,25100000
free state of jones,STX,20800000,4200000,2016,25000000
a beautiful planet,Imax,15500000,9400000,2016,24900000
god's not dead 2,PFR,20800000,3700000,2016,24500000
silence (2016),Par.,7100000,16600000,2016,23700000
middle school: the worst years of my life,LGF,20000000,3300000,2016,23300000
triple 9,ORF,12600000,10500000,2016,23100000
whiskey tango foxtrot,Par.,23100000,0,2016,23100000
captain fantastic,BST,5900000,16900000,2016,22800000
live by night,WB,10400000,12300000,2016,22700000
julieta,SPC,1500000,21000000,2016,22500000
solace,LGP,0,22400000,2016,22400000
fifty shades of black,ORF,11700000,10500000,2016,22200000
keanu,WB (NL),20600000,0,2016,20600000
el clan,FIP,201000,20200000,2016,20401000
the edge of seventeen,STX,14400000,4400000,2016,18800000
the choice,LGF,18700000,0,2016,18700000
eye in the sky,BST,18700000,0,2016,18700000
bad santa 2,BG,17800000,0,2016,17800000
regression,W/Dim.,55000,17600000,2016,17655000
neerja,FIP,1600000,16000000,2016,17600000
masterminds (2016),Rela.,17400000,0,2016,17400000
norm of the north,LGF,17100000,0,2016,17100000
hardcore henry,STX,9300000,7600000,2016,16900000
pride and prejudice and zombies,SGem,10900000,5500000,2016,16400000
the infiltrator,BG,15400000,0,2016,15400000
kapoor & sons - since 1921,FIP,2600000,12800000,2016,15400000
the take (2016),HTR,50300,14800000,2016,14850300
sword master,WGUSA,75500,14600000,2016,14675500
"hello, my name is doris",RAtt.,14400000,0,2016,14400000
the other side of the door,Fox,3000000,11300000,2016,14300000
love & friendship,RAtt.,14000000,0,2016,14000000
jackie,FoxS,14000000,0,2016,14000000
sing street,Wein.,3200000,10400000,2016,13600000
shut in,EC,6900000,6200000,2016,13100000
loving,Focus,7800000,5200000,2016,13000000
the beatles: eight days a week - the touring years,Abr.,2900000,9400000,2016,12300000
the man who knew infinity,IFC,3900000,8400000,2016,12300000
no manches frida,PNT,11500000,0,2016,11500000
the darkness,BH Tilt,10800000,0,2016,10800000
our kind of traitor,RAtt.,3200000,7600000,2016,10800000
the perfect match,LGF,9700000,745000,2016,10445000
queen of katwe,BV,8900000,1500000,2016,10400000
miss sloane,EC,3500000,5600000,2016,9100000
ratchet & clank,Focus,8800000,0,2016,8800000
morgan,Fox,3900000,4900000,2016,8800000
the lobster (us release),A24,8700000,0,2016,8700000
my king (mon roi),FM,54100,7900000,2016,7954100
pele: birth of a legend,IFC,57000,7800000,2016,7857000
a bigger splash,FoxS,2000000,5500000,2016,7500000
southside with you,RAtt.,6300000,208000,2016,6508000
the young messiah,Focus,6500000,0,2016,6500000
incarnate,BH Tilt,4800000,1500000,2016,6300000
max steel,ORF,3800000,2500000,2016,6300000
midnight special,WB,3700000,2500000,2016,6200000
the duelist,Sony,13500,6100000,2016,6113500
the autopsy of jane doe,IFC,10500,6000000,2016,6010500
my best friend's wedding (2016),Sony,78600,5600000,2016,5678600
genius,RAtt.,1400000,4300000,2016,5700000
20th century women,A24,5700000,0,2016,5700000
hunt for the wilderpeople,Orch.,5200000,0,2016,5200000
bleed for this,ORF,5100000,0,2016,5100000
hands of stone,Wein.,4700000,0,2016,4700000
men & chicken,Drft.,30200,4600000,2016,4630200
the meddler,SPC,4300000,0,2016,4300000
a hologram for the king,RAtt.,4200000,0,2016,4200000
swiss army man,A24,4200000,0,2016,4200000
denial,BST,4099999,0,2016,4099999
indignation,RAtt.,3400000,523000,2016,3923000
kabali,CineGalaxy,3900000,0,2016,3900000
rules don't apply,Fox,3700000,233000,2016,3933000
where to invade next,Drft.,3800000,0,2016,3800000
batman: the killing joke,Fathom,3800000,0,2016,3800000
naam hai akira,FIP,219000,3500000,2016,3719000
a man called ove,MBox,3500000,0,2016,3500000
miles ahead,SPC,2600000,850000,2016,3450000
everybody wants some!!,Par.,3400000,0,2016,3400000
maggie's plan,SPC,3400000,0,2016,3400000
the program (2016),EOne,13100,3300000,2016,3313100
green room,A24,3200000,0,2016,3200000
the eagle huntress,SPC,3200000,0,2016,3200000
compadres,PNT,3100000,0,2016,3100000
desierto,STX,2000000,1000000,2016,3000000
anthropoid,BST,3000000,0,2016,3000000
hillsong - let hope rise,PFR,2400000,255000,2016,2655000
el jeremias,Sony,650000,1900000,2016,2550000
the disappointments room,Rela.,2400000,0,2016,2400000
dear zindagi,Relbig.,2400000,0,2016,2400000
elle,SPC,2300000,0,2016,2300000
paterson,BST,2200000,0,2016,2200000
equals,A24,33300,2100000,2016,2133300
i'm not ashamed,PFR,2100000,0,2016,2100000
the dressmaker,BG,2000000,0,2016,2000000
the handmaiden,Magn.,2000000,0,2016,2000000
demolition,FoxS,2000000,0,2016,2000000
american honey,A24,663000,1200000,2016,1863000
busco novio para mi mujer,PNT,1700000,0,2016,1700000
a perfect day,IFC,14000,1700000,2016,1714000
weiner,IFC,1700000,0,2016,1700000
rustom,Zee,1100000,571000,2016,1671000
i saw the light,SPC,1600000,0,2016,1600000
jane got a gun,Wein.,1500000,0,2016,1500000
toni erdmann,SPC,1500000,0,2016,1500000
the neon demon,BG,1300000,0,2016,1300000
embrace of the serpent,Osci.,1300000,0,2016,1300000
housefull 3,Eros,1300000,0,2016,1300000
mohenjo daro,UTV,1300000,0,2016,1300000
lazer team,Ampl.,1200000,0,2016,1200000
the music of strangers,Orch.,1200000,0,2016,1200000
dough,Men.,1100000,0,2016,1100000
ma ma,Osci.,47300,1100000,2016,1147300
wazir,Relbig.,1100000,0,2016,1100000
papa: hemingway in cuba,YFG,1100000,0,2016,1100000
certain women,IFC,1100000,0,2016,1100000
the innocents,MBox,1100000,0,2016,1100000
elvis & nixon,BST,1100000,0,2016,1100000
operation chromite,CJ,1000000,0,2016,1000000
baar baar dekho,Eros,982000,0,2016,982000
dark horse (2016),SPC,941000,0,2016,941000
neruda,Orch.,939000,0,2016,939000
gentleman,Gaatri,898000,0,2016,898000
ki & ka,Eros,858000,0,2016,858000
dishoom,Eros,813000,0,2016,813000
the wailing (goksung),WGUSA,787000,0,2016,787000
chongqing hot pot,CL,780000,0,2016,780000
the polar express (2016 re-issue),WB,765000,0,2016,765000
little men (2016),Magn.,703000,0,2016,703000
chaar sahibzaade: rise of band singh bahadur,Eros,701000,0,2016,701000
born to be blue (us release),IFC,678000,0,2016,678000
city of gold,IFC,641000,0,2016,641000
remember (us release),A24,638000,0,2016,638000
embrace: the documentary,Gathr,629000,0,2016,629000
tickled,Magn.,614000,0,2016,614000
"lo and behold, reveries of the connected world",Magn.,595000,0,2016,595000
a tale of love and darkness,FCW,572000,0,2016,572000
tunnel,WGUSA,569000,0,2016,569000
knight of cups,BG,566000,0,2016,566000
harry & snowman,FR,561000,0,2016,561000
viral,W/Dim.,0,552000,2016,552000
american pastoral,LGF,544000,0,2016,544000
the age of shadows,CJ,542000,0,2016,542000
fitoor,UTV,529000,0,2016,529000
the first monday in may,Magn.,527000,0,2016,527000
marguerite,Cohen,497000,0,2016,497000
the boy and the beast,FUN,491000,0,2016,491000
wiener-dog,IFC,477000,0,2016,477000
our little sister,SPC,468000,0,2016,468000
only yesterday (2016 re-release),GK,453000,0,2016,453000
baaghi,UTV,438000,0,2016,438000
land of mine,SPC,435000,0,2016,435000
things to come,IFC,388000,0,2016,388000
the lobster (canada release),Mon,377000,0,2016,377000
mr. donkey,CL,356000,0,2016,356000
happy bhaag jayegi,Eros,352000,0,2016,352000
high-rise,Magn.,346000,0,2016,346000
te3n,Rel.,332000,0,2016,332000
francofonia,MBox,307000,0,2016,307000
mia madre,MBox,303000,0,2016,303000
april and the extraordinary world,GK,295000,0,2016,295000
ixcanul,KL,295000,0,2016,295000
the people vs. fritz bauer,Cohen,288000,0,2016,288000
aquarius,Vita.,286000,0,2016,286000
kingsglaive: final fantasy: xv,VE,270000,0,2016,270000
my golden days,Magn.,269000,0,2016,269000
the family fang,SM,263000,0,2016,263000
dheepan,IFC,262000,0,2016,262000
"life, animated",Orch.,255000,0,2016,255000
oasis: supersonic,A24,243000,0,2016,243000
the invitation,Drft.,232000,0,2016,232000
miss hokusai,GK,223000,0,2016,223000
kaptaan,UTV,204000,0,2016,204000
league of gods,Sony,182000,0,2016,182000
viva,Magn.,178000,0,2016,178000
the wave,Magn.,177000,0,2016,177000
asura: the city of madness,CJ,176000,0,2016,176000
louder than bombs,Orch.,164000,0,2016,164000
howards end (2016 restoration),Cohen,160000,0,2016,160000
sunset song,Magn.,160000,0,2016,160000
born to be blue,EOne,152000,0,2016,152000
seasons,MBox,150000,0,2016,150000
rams (hr√∫tar),Cohen,149000,0,2016,149000
tumbledown,SM,135000,0,2016,135000
the brand new testament,MBox,128000,0,2016,128000
spirits' homecoming,PM&E,126000,0,2016,126000
sweet bean,KL,125000,0,2016,125000
a war,Magn.,123000,0,2016,123000
fire at sea,KL,121000,0,2016,121000
hockney,FM,121000,0,2016,121000
three,WGUSA,120000,0,2016,120000
tale of tales,IFC,119000,0,2016,119000
the measure of a man,KL,112000,0,2016,112000
aferim!,BWP,108000,0,2016,108000
until forever (por siempre),CZ,105000,0,2016,105000
under the sun (2016),Icar.,105000,0,2016,105000
our last tango,Strand,100000,0,2016,100000
rock on 2,Eros,98900,0,2016,98900
seondal: the man who sells the river,CJ,97500,0,2016,97500
so young 2: never gone,CL,96400,0,2016,96400
"new york, new york (2016)",CL,92400,0,2016,92400
fireworks wednesday,Ghop,90500,0,2016,90500
no one's life is easy: so i married an anti-fan,CL,89300,0,2016,89300
"my love, don't cross that river",FM,88000,0,2016,88000
author: the jt leroy story,Magn.,86000,0,2016,86000
mountains may depart,KL,82900,0,2016,82900
cock and bull,CL,82800,0,2016,82800
a street cat named bob,Cleopatra,82700,0,2016,82700
les cowboys,Cohen,80800,0,2016,80800
saala khadoos,UTV,76900,0,2016,76900
the monster (2016),A24,12500,62200,2016,74700
dancer,IFC,71900,0,2016,71900
sweet 20,CJ,71800,0,2016,71800
the dark horse,BG,67500,0,2016,67500
phantom detective,CJ,67100,0,2016,67100
ran (2016 re-issue),Rialto,66100,0,2016,66100
microbe & gasoline,Scre.,63800,0,2016,63800
time renegades,CJ,59400,0,2016,59400
vanishing time: a boy who returned,Dreamwest,57800,0,2016,57800
dongju: the portrait of a poet,CJ,56600,0,2016,56600
l'attesa,Osci.,55800,0,2016,55800
the lovers and the despot,Magn.,55500,0,2016,55500
clown,W/Dim.,55000,0,2016,55000
diary of a chambermaid,Cohen,54200,0,2016,54200
high strung (2016),Pala.,53400,0,2016,53400
the club,MBox,52800,0,2016,52800
being 17,Strand,52700,0,2016,52700
the last man on the moon,Grav.,52500,0,2016,52500
my annoying brother,CJ,52000,0,2016,52000
cemetery of splendor,Strand,52000,0,2016,52000
disorder,IFC,51900,0,2016,51900
like for likes,CJ,50800,0,2016,50800
in the shadow of women,Distrib.,50300,0,2016,50300
in order of disappearance,Magn.,50300,0,2016,50300
the treasure,SDS,50200,0,2016,50200
fatima,KL,50100,0,2016,50100
we are x,Drft.,45300,0,2016,45300
a melody to remember,CJ,44300,0,2016,44300
phantom of the theatre,WGUSA,44000,0,2016,44000
mastizaade,Eros,43400,0,2016,43400
closet monster,Strand,42200,0,2016,42200
troublemakers: the story of land art,FRun,29500,9100,2016,38600
come what may,Cohen,37800,0,2016,37800
until forever,Linn,35800,0,2016,35800
summertime (2016),Strand,35300,0,2016,35300
songs my brothers taught me,KL,34800,0,2016,34800
mr. right,FCW,34700,0,2016,34700
phantom boy,GK,34400,0,2016,34400
sweet sixteen (xia you qiao mu),CL,34300,0,2016,34300
eisenstein in guanajuato,Strand,34300,0,2016,34300
last cab to darwin,FRun,34200,0,2016,34200
the map against the world,CJ,34000,0,2016,34000
kaili blues,Ghop,32200,0,2016,32200
anesthesia,IFC,32200,0,2016,32200
"rio, i love you",Scre.,32000,0,2016,32000
as i open my eyes,KL,31000,0,2016,31000
the son of joseph,KL,30600,0,2016,30600
from afar,Strand,30200,0,2016,30200
for a few bullets,CL,30100,0,2016,30100
the last princess,CJ,29300,0,2016,29300
valley of love,Strand,28600,0,2016,28600
blackway,Electric,27100,0,2016,27100
neon bull,KL,26700,0,2016,26700
papa (luo shan ji dao dan ji hua),Jampa,26700,0,2016,26700
standing tall (la tete haute),Cohen,26100,0,2016,26100
chevalier,Strand,25700,0,2016,25700
the new year's eve of old lee,CL,25400,0,2016,25400
cosmos,KL,25300,0,2016,25300
a monster with a thousand heads,MBox,24900,0,2016,24900
evolution,IFC,24800,0,2016,24800
"right now, wrong then",Ghop,24500,0,2016,24500
lolo,FR,24100,0,2016,24100
sanam teri kasam,Eros,22100,0,2016,22100
term life,FCW,21300,0,2016,21300
the sea of trees,A24,20400,0,2016,20400
wildflower (secretos del alma),CZ,18100,0,2016,18100
colonia,Scre.,15700,0,2016,15700
argentina,FRun,14900,0,2016,14900
remember you,CJ,14800,0,2016,14800
adderall diaries,A24,13200,0,2016,13200
neither heaven nor earth,FM,12800,0,2016,12800
the ones below,Magn.,12500,0,2016,12500
"kiki, love to love",Strand,12500,0,2016,12500
don't call me son,Zeit.,11700,0,2016,11700
jeruzalem,EpicPics,11300,0,2016,11300
serial killer 1,KL,10300,0,2016,10300
chronic,MR,9000,0,2016,9000
magnus,FR,8900,0,2016,8900
the last king,Magn.,8900,0,2016,8900
mojave,A24,8300,0,2016,8300
the other side,FM,8100,0,2016,8100
the president,Crnth,7600,0,2016,7600
they will have to kill us first,BBC,7500,0,2016,7500
the carer,Crnth,6200,0,2016,6200
klown forever,Drft.,5700,0,2016,5700
search party,FCW,4600,0,2016,4600
in harmony,Distrib.,3100,0,2016,3100
in her name (au nom de ma fille),Distrib.,1600,0,2016,1600
next time i'll aim for the heart,Distrib.,800,0,2016,800
the student and mr. henri,Distrib.,800,0,2016,800
down by love,Distrib.,700,0,2016,700
news from planet mars,KL,300,0,2016,300
satanic,Magn.,300,0,2016,300
star wars: the last jedi,BV,620200000,712400000,2017,1332600000
beauty and the beast (2017),BV,504000000,759500000,2017,1263500000
the fate of the furious,Uni.,226000000,1010,2017,226001010
despicable me 3,Uni.,264600000,770200000,2017,1034800000
jumanji: welcome to the jungle,Sony,404500000,557600000,2017,962100000
spider-man: homecoming,Sony,334200000,546000000,2017,880200000
wolf warrior 2,HC,2700000,867600000,2017,870300000
guardians of the galaxy vol. 2,BV,389800000,473900000,2017,863700000
thor: ragnarok,BV,315100000,538900000,2017,854000000
wonder woman,WB,412600000,409300000,2017,821900000
coco,BV,209700000,597400000,2017,807100000
pirates of the caribbean: dead men tell no tales,BV,172600000,622300000,2017,794900000
it,WB (NL),327500000,372900000,2017,700400000
justice league,WB,229000000,428900000,2017,657900000
logan (2017),Fox,226300000,392700000,2017,619000000
transformers: the last knight,Par.,130199999,475300000,2017,605499999
kong: skull island,WB,168100000,398600000,2017,566700000
the boss baby,Fox,175000000,353000000,2017,528000000
dunkirk,WB,188000000,337200000,2017,525200000
war for the planet of the apes,Fox,146900000,343800000,2017,490700000
the greatest showman,Fox,174300000,260700000,2017,435000000
kingsman: the golden circle,Fox,100200000,310700000,2017,410900000
the mummy (2017),Uni.,80200000,329000000,2017,409200000
cars 3,BV,152900000,231000000,2017,383900000
fifty shades darker,Uni.,114600000,267000000,2017,381600000
your name.,FUN,5000000,353000000,2017,358000000
murder on the orient express (2017),Fox,102800000,250000000,2017,352800000
xxx: the return of xander cage,Par.,44900000,301200000,2017,346100000
the great wall,Uni.,45500000,289400000,2017,334900000
resident evil: the final chapter,SGem,26800000,285400000,2017,312200000
the lego batman movie,WB,175800000,136200000,2017,312000000
annabelle: creation,WB (NL),102100000,204400000,2017,306500000
wonder,LGF,132400000,173500000,2017,305900000
ferdinand,Fox,84400000,211700000,2017,296100000
split,Uni.,138300000,140200000,2017,278500000
blade runner 2049,WB,92100000,167200000,2017,259300000
get out,Uni.,176000000,79400000,2017,255400000
kung fu yoga,WGUSA,363000,253800000,2017,254163000
baahubali 2: the conclusion,GrtIndia,20200000,234000000,2017,254200000
journey to the west: the demons strike back,Sony,880000,245700000,2017,246580000
alien: covenant,Fox,74300000,166600000,2017,240900000
baby driver,TriS,107800000,119100000,2017,226900000
valerian and the city of a thousand planets,STX,41200000,184700000,2017,225900000
geostorm,WB,33700000,187900000,2017,221600000
the emoji movie,Sony,86100000,131699999,2017,217799999
a dog's purpose,Uni.,64500000,140500000,2017,205000000
smurfs: the lost village,Sony,45000000,152200000,2017,197200000
the shape of water,FoxS,63900000,131400000,2017,195300000
pitch perfect 3,Uni.,104900000,80500000,2017,185400000
daddy's home 2,Par.,104000000,76600000,2017,180600000
the post,Fox,81900000,97900000,2017,179800000
baywatch,Par.,58100000,119800000,2017,177900000
the hitman's bodyguard,LG/S,75500000,101100000,2017,176600000
john wick: chapter two,LG/S,92000000,79500000,2017,171500000
ghost in the shell (2017),Par.,40600000,129199999,2017,169799999
"three billboards outside ebbing, missouri",FoxS,54500000,104700000,2017,159200000
duckweed,CL,472000,150600000,2017,151072000
darkest hour,Focus,56500000,94400000,2017,150900000
king arthur: legend of the sword,WB,39200000,109500000,2017,148700000
the foreigner,STX,34400000,111000000,2017,145400000
power rangers (2017),LGF,85400000,57000000,2017,142400000
girls trip,Uni.,115200000,25400000,2017,140600000
american made,Uni.,51300000,83500000,2017,134800000
a bad moms christmas,STX,72100000,58400000,2017,130500000
captain underpants: the first epic movie,Fox,73900000,51600000,2017,125500000
happy death day,Uni.,55700000,69800000,2017,125500000
the lego ninjago movie,WB,59300000,63800000,2017,123100000
the dark tower,Sony,50700000,62500000,2017,113200000
buddies in india,CL,293000,109300000,2017,109593000
leap!,Wein.,21900000,81400000,2017,103300000
jigsaw,LGF,38100000,64900000,2017,103000000
railroad tigers,WGUSA,218000,102000000,2017,102218000
life (2017),Sony,30200000,70300000,2017,100500000
atomic blonde,Focus,51700000,48300000,2017,100000000
the shack,LG/S,57400000,39600000,2017,97000000
some like it hot (qing shung),CL,100000,95600000,2017,95700000
tiger zinda hai,Yash,5600000,81800000,2017,87400000
going in style (2017),WB (NL),45000000,39900000,2017,84900000
rings,Par.,27800000,55300000,2017,83100000
a taxi driver,WGUSA,1500000,80100000,2017,81600000
underworld: blood wars,SGem,30400000,50700000,2017,81100000
lady bird,A24,49000000,30000000,2017,79000000
american assassin,LGF,36200000,31000000,2017,67200000
one piece film: gold,FUN,424000,65800000,2017,66224000
victoria and abdul,Focus,22200000,43200000,2017,65400000
the nut job 2: nutty by nature,ORF,28400000,36800000,2017,65200000
monster trucks,Par.,33400000,31100000,2017,64500000
the mountain between us,Fox,30300000,32500000,2017,62800000
the star,Sony,40900000,22000000,2017,62900000
how to be a latin lover,PNT,32100000,29700000,2017,61800000
"everything, everything",WB,34100000,27500000,2017,61600000
snatched,Fox,45900000,15000000,2017,60900000
my little pony: the movie,LGF,21900000,38400000,2017,60300000
molly's game,STX,28800000,30500000,2017,59300000
all the money in the world,TriS,25100000,31900000,2017,57000000
the big sick,LGF,42900000,13500000,2017,56400000
confidential assignment,CJ,476000,55500000,2017,55976000
downsizing,Par.,24400000,30600000,2017,55000000
"i, tonya",Neon,30000000,23900000,2017,53900000
logan lucky,BST,27800000,20700000,2017,48500000
tyler perry's boo 2! a madea halloween,LGF,47300000,1000000,2017,48300000
phantom thread,Focus,21200000,26600000,2017,47800000
rough night,Sony,22100000,25200000,2017,47300000
the battleship island,CJ,1100000,45000000,2017,46100000
flatliners (2017),Sony,16900000,28300000,2017,45200000
all eyez on me,LG/S,44900000,0,2017,44900000
mother!,Par.,17800000,26700000,2017,44500000
47 meters down,ENTMP,44300000,0,2017,44300000
the snowman,Uni.,6700000,36400000,2017,43100000
gifted,FoxS,24800000,18200000,2017,43000000
loving vincent,Good Deed,6700000,35500000,2017,42200000
call me by your name,SPC,18100000,23800000,2017,41900000
t2: trainspotting,TriS,2400000,39300000,2017,41700000
fist fight,WB (NL),32200000,8900000,2017,41100000
diary of a wimpy kid: the long haul,Fox,20700000,19400000,2017,40100000
the house,WB (NL),25600000,8600000,2017,34200000
tad the lost explorer and the secret of king midas,ParC,5900,34200000,2017,34205900
wind river,Wein.,33800000,0,2017,33800000
sleepless,ORF,20800000,12100000,2017,32900000
kidnap (2017),Aviron,31000000,0,2017,31000000
the disaster artist,A24,21100000,8700000,2017,29800000
hostiles,ENTMP,29800000,0,2017,29800000
the beguiled (2017),Focus,10700000,16700000,2017,27400000
home again,ORF,27000000,0,2017,27000000
judwaa 2,FIP,1400000,25500000,2017,26900000
chips,WB,18600000,8199999,2017,26799999
the bye bye man,STX,22400000,4300000,2017,26700000
a cure for wellness,Fox,8100000,18500000,2017,26600000
the zookeeper's wife,Focus,17600000,8600000,2017,26200000
only the brave,Sony,18300000,7400000,2017,25700000
father figures,WB,17500000,8100000,2017,25600000
badrinath ki dulhania,FIP,2000000,23200000,2017,25200000
born in china,BV,13900000,11200000,2017,25100000
the founder,Wein.,12800000,11300000,2017,24100000
jolly llb 2,FIP,1700000,21300000,2017,23000000
the glass castle,LGF,17300000,4600000,2017,21900000
sword art online: the movie - ordinal scale,Elev.,1500000,19200000,2017,20700000
the circle (2017),STX,20500000,0,2017,20500000
it comes at night,A24,14000000,5300000,2017,19300000
the lost city of z,BST,8600000,10700000,2017,19300000
unforgettable (2017),WB,11400000,6400000,2017,17800000
the case for christ,PFR,14700000,3000000,2017,17700000
detroit,Annapurna,16800000,0,2017,16800000
wonder wheel,Amazon,1400000,14500000,2017,15900000
gold,Wein.,7200000,7700000,2017,14900000
the space between us,STX,7900000,6900000,2017,14800000
wish upon,BG,14300000,0,2017,14300000
a united kingdom,FoxS,3900000,9900000,2017,13800000
"roman j. israel, esq.",Sony,12000000,1100000,2017,13100000
mubarakan,Sony,759000,12100000,2017,12859000
battle of the sexes,FoxS,12600000,0,2017,12600000
the promise (2017),ORF,8199999,4200000,2017,12399999
before i fall,ORF,12200000,0,2017,12200000
earth: one amazing day,BBC,81300,11600000,2017,11681300
thank you for your service (2017),Uni.,9500000,0,2017,9500000
rock dog,LG/S,9400000,0,2017,9400000
my cousin rachel,FoxS,2700000,6500000,2017,9200000
truman,FR,211000,8800000,2017,9011000
stronger,RAtt.,4200000,4200000,2017,8400000
tulip fever,Wein.,2500000,5900000,2017,8400000
viceroy's house,IFC,1100000,6700000,2017,7800000
amityville: the awakening,W/Dim.,700,7700000,2017,7700700
just getting started,BG,6100000,1600000,2017,7700000
beatriz at dinner,RAtt.,7100000,310000,2017,7410000
i am not your negro,Magn.,7100000,0,2017,7100000
the red turtle,SPC,922000,5700000,2017,6622000
from the land of the moon,IFC,47700,6500000,2017,6547700
maudie,SPC,6200000,0,2017,6200000
all saints,Affirm,5800000,140000,2017,5940000
the florida project,A24,5900000,0,2017,5900000
suburbicon,Par.,5800000,0,2017,5800000
the man who invented christmas,BST,5700000,0,2017,5700000
paris can wait,SPC,5600000,0,2017,5600000
phillauri,FIP,468000,5000000,2017,5468000
ok jaanu,FIP,356000,5000000,2017,5356000
an inconvenient sequel: truth to power,Par.,3500000,1900000,2017,5400000
table 19,FoxS,3600000,1400000,2017,5000000
collide,ORF,2300000,2500000,2017,4800000
the wall,RAtt.,1800000,2700000,2017,4500000
mark felt: the man who brought down the white house,SPC,769000,3600000,2017,4369000
terminator 2: judgment day 3d,Distrib.,1000000,2900000,2017,3900000
brad's status,Annapurna,2100000,1700000,2017,3800000
friend request,ENTMP,3800000,0,2017,3800000
their finest,STX,3600000,0,2017,3600000
wonderstruck,RAtt.,1100000,2200000,2017,3300000
the leisure seeker,SPC,3200000,0,2017,3200000
raw (2017),FCW,515000,2600000,2017,3115000
colossal,Neon,3000000,0,2017,3000000
a gentleman,FIP,410000,2500000,2017,2910000
inhumans,Imax,1500000,1300000,2017,2800000
kedi,Osci.,2800000,0,2017,2800000
the only living boy in new york,RAtt.,624000,1900000,2017,2524000
hazlo como hombre (do it like an hombre),PNT,2500000,0,2017,2500000
poster boys,Sony,97000,2400000,2017,2497000
the salesman,Cohen,2400000,0,2017,2400000
pokemon the movie: i choose you!,Fathom,2400000,0,2017,2400000
jeepers creepers 3,Scre.,2300000,0,2017,2300000
un padre no tan padre,PNT,2200000,0,2017,2200000
good time,A24,2000000,0,2017,2000000
everybody loves somebody,PNT,1900000,0,2017,1900000
along with the gods: the two worlds,WGUSA,1900000,0,2017,1900000
youth (2017),CL,1900000,0,2017,1900000
last flag flying,LGF,965000,904000,2017,1869000
a quiet passion,MBox,1900000,0,2017,1900000
free fire,A24,1800000,0,2017,1800000
the last word,BST,1800000,0,2017,1800000
human flow,Magn.,528000,1300000,2017,1828000
jane (2017),Abr.,1700000,0,2017,1700000
a ghost story,A24,1600000,0,2017,1600000
the square,Magn.,1500000,0,2017,1500000
patti cake$,FoxS,800000,682000,2017,1482000
the wedding plan,RAtt.,1400000,0,2017,1400000
personal shopper,IFC,1300000,0,2017,1300000
churchill,Cohen,1300000,0,2017,1300000
the sense of an ending,CBS,1300000,0,2017,1300000
3 idiotas,PNT,1200000,0,2017,1200000
6 below: miracle on the mountain,MOM,14800,1100000,2017,1114800
lady macbeth,RAtt.,1100000,0,2017,1100000
film stars don't die in liverpool,SPC,1000000,0,2017,1000000
yu-gi-oh! the dark side of dimensions,SV,1000000,0,2017,1000000
lucky (2017),Magn.,956000,0,2017,956000
faces places,Cohen,954000,0,2017,954000
tubelight,Yash,930000,0,2017,930000
frantz,MBox,881000,0,2017,881000
bombshell: the hedy lamarr story,Zeit.,820000,0,2017,820000
walk with me,Gathr,727000,0,2017,727000
buena vista social club: adios,BG,123000,578000,2017,701000
titanic (20th anniversary),Par.,692000,0,2017,692000
lost in paris,Osci.,692000,0,2017,692000
shubh mangal saavdhan,Eros,690000,0,2017,690000
the midwife,MBox,604000,0,2017,604000
3 generations,Wein.,156000,375000,2017,531000
fairy tail: dragon cry,FUN,519000,0,2017,519000
our president,CJ,507000,0,2017,507000
letters from baghdad,Vita.,360000,143000,2017,503000
breathe (2017),BST,490000,0,2017,490000
song to song,BG,444000,0,2017,444000
tom of finland,KL,378000,0,2017,378000
god's own country,Orion,336000,0,2017,336000
the breadwinner,GK,312000,0,2017,312000
a silent voice,Elev.,310000,0,2017,310000
my life as a zucchini,GK,310000,0,2017,310000
happy end,SPC,302000,0,2017,302000
after the storm,FM,272000,0,2017,272000
wakefield,IFC,263000,0,2017,263000
"i, daniel blake",IFC,260000,0,2017,260000
cezanne et moi,Magn.,258000,0,2017,258000
the fortress,CJ,253000,0,2017,253000
black butler: book of the atlantic,FUN,248000,0,2017,248000
the swindlers,WGUSA,242000,0,2017,242000
city of ghosts,IFC,128000,100000,2017,228000
the prison,WGUSA,207000,0,2017,207000
the other side of hope,Jan.,184000,0,2017,184000
marjorie prime,FR,181000,0,2017,181000
graduation,IFC,176000,0,2017,176000
mr. gaga: a true story of love and dance,Abr.,174000,0,2017,174000
in this corner of the world,FUN,172000,0,2017,172000
david lynch: the art life,Jan.,171000,0,2017,171000
13 minutes,SPC,162000,0,2017,162000
the journey,IFC,155000,0,2017,155000
the void,Scre.,151000,0,2017,151000
blade of the immortal,Magn.,151000,0,2017,151000
thelma,Orch.,147000,0,2017,147000
bpm (beats per minute),Orch.,125000,0,2017,125000
explosion,CL,123000,0,2017,123000
the king's choice,Gold.,113000,0,2017,113000
slack bay,KL,113000,0,2017,113000
like crazy (2017),Strand,107000,0,2017,107000
fabricated city,CJ,105000,0,2017,105000
the lure,Jan.,102000,0,2017,102000
score: a film music documentary,Grav.,101000,0,2017,101000
munna michael,Eros,99600,0,2017,99600
the mayor,WGUSA,96800,0,2017,96800
the fencer,CFI,96000,0,2017,96000
memoir of a murderer,WGUSA,91300,0,2017,91300
the king's case note,CJ,91000,0,2017,91000
warriors of the dawn,FIP,84500,0,2017,84500
the nile hilton incident,Strand,81100,0,2017,81100
pop aye,KL,78000,0,2017,78000
i can speak,CJ,63200,0,2017,63200
tomorrow,UTMW,62500,0,2017,62500
worlds apart,CLS,60300,0,2017,60300
extraordinary mission,Crimson,54200,0,2017,54200
the ornithologist,Strand,50500,0,2017,50500
napping princess,GK,48200,0,2017,48200
twenty two,CL,46800,0,2017,46800
bluebeard,WGUSA,43100,0,2017,43100
one week and a day,Osci.,41600,0,2017,41600
the commune,Magn.,38700,0,2017,38700
a woman's life,KL,37600,0,2017,37600
afterimage,FM,33400,0,2017,33400
alone in berlin,IFC,33100,0,2017,33100
the villainess,WGUSA,27700,0,2017,27700
the daughter,KL,26400,0,2017,26400
moscow never sleeps,CAVU,25300,0,2017,25300
my scientology movie,Magn.,22900,0,2017,22900
una,EF,22800,0,2017,22800
bending the arc,Abr.,21900,0,2017,21900
the girl without hands,GK,21800,0,2017,21800
whisky galore,Arrow,21000,0,2017,21000
rv: resurrected victims,WGUSA,20400,0,2017,20400
better watch out,WGUSA,20400,0,2017,20400
absolutely anything,ADC,20200,0,2017,20200
glory (2017),FM,18400,0,2017,18400
porto,KL,15100,0,2017,15100
brotherhood of blades 2: the infernal battlefield,WGUSA,14200,0,2017,14200
abracadabra,Sony,14000,0,2017,14000
blind,VE,12500,0,2017,12500
felicite,Strand,12400,0,2017,12400
dead awake (2017),FR,11500,0,2017,11500
the country doctor,Distrib.,8500,0,2017,8500
overdrive,VE,7800,0,2017,7800
suntan,Strand,6600,0,2017,6600
trespass against us,A24,5700,0,2017,5700
the ardennes,FM,5600,0,2017,5600
oro,Sony,5500,0,2017,5500
singularity,VE,4200,0,2017,4200
emily (2017),Hiber,3600,0,2017,3600
max & leon,Distrib.,500,0,2017,500
2:22,Magn.,400,0,2017,400
avengers: infinity war,BV,678800000,1369,2018,678801369
black panther,BV,700100000,646900000,2018,1347000000
jurassic world: fallen kingdom,Uni.,417700000,891800000,2018,1309500000
incredibles 2,BV,608600000,634200000,2018,1242800000
aquaman,WB,335100000,812700000,2018,1147800000
bohemian rhapsody,Fox,216400000,687200000,2018,903600000
venom (2018),Sony,213500000,641500000,2018,855000000
mission: impossible - fallout,Par.,220200000,571000000,2018,791200000
deadpool 2,Fox,318500000,460500000,2018,779000000
fantastic beasts: the crimes of grindelwald,WB,159600000,494100000,2018,653700000
ant-man and the wasp,BV,216600000,406000000,2018,622600000
ready player one,WB,137700000,445200000,2018,582900000
operation red sea,WGUSA,1500000,577700000,2018,579200000
detective chinatown 2,WB,2000000,542100000,2018,544100000
the meg,WB,145400000,384800000,2018,530200000
ralph breaks the internet,BV,201100000,328100000,2018,529200000
hotel transylvania 3: summer vacation,Sony,167500000,361100000,2018,528600000
dr. seuss' the grinch (2018),Uni.,270600000,241000000,2018,511600000
bumblebee,Par.,127200000,340800000,2018,468000000
a star is born (2018),WB,215300000,218900000,2018,434200000
rampage (2018),WB (NL),101000000,327000000,2018,428000000
mamma mia! here we go again,Uni.,120600000,274400000,2018,395000000
solo: a star wars story,BV,213800000,179200000,2018,393000000
spider-man: into the spider-verse,Sony,190200000,185300000,2018,375500000
fifty shades freed,Uni.,100400000,271500000,2018,371900000
the nun,WB (NL),117500000,248100000,2018,365600000
monster hunt 2,LGF,706000,361000000,2018,361706000
peter rabbit,Sony,115300000,236000000,2018,351300000
mary poppins returns,BV,172000000,177600000,2018,349600000
a quiet place,Par.,188000000,152900000,2018,340900000
green book,Uni.,85100000,234700000,2018,319800000
skyscraper,Uni.,68400000,236400000,2018,304800000
ocean's 8,WB,140200000,157500000,2018,297700000
pacific rim uprising,Uni.,59900000,231100000,2018,291000000
maze runner: the death cure,Fox,58000000,230200000,2018,288200000
tomb raider,WB,58300000,216400000,2018,274700000
halloween (2018),Uni.,159300000,96100000,2018,255400000
crazy rich asians,WB,174500000,64000000,2018,238500000
paddington 2,WB,40900000,186400000,2018,227300000
smallfoot,WB,83200000,130900000,2018,214100000
creed ii,MGM,115700000,98300000,2018,214000000
disney's christopher robin,BV,99200000,98500000,2018,197700000
the equalizer 2,Sony,102100000,88300000,2018,190400000
the nutcracker and the four realms,BV,54900000,119100000,2018,174000000
the mule,WB,103800000,68700000,2018,172500000
insidious: the last key,Uni.,67700000,100100000,2018,167800000
the predator (2018),Fox,51000000,109500000,2018,160500000
johnny english strikes again,Uni.,4400000,154500000,2018,158900000
red sparrow,Fox,46900000,104700000,2018,151600000
the first purge,Uni.,69500000,67500000,2018,137000000
a wrinkle in time,BV,100500000,32200000,2018,132700000
the house with a clock in its walls,Uni.,68500000,62900000,2018,131400000
instant family,Par.,67400000,53200000,2018,120600000
the commuter,LGF,36300000,83600000,2018,119900000
game night,WB (NL),69200000,48500000,2018,117700000
the monkey king 3,WGUSA,187000,114900000,2018,115087000
first man,Uni.,44900000,60800000,2018,105700000
night school (2018),Uni.,77300000,25800000,2018,103100000
alpha,Studio 8,35900000,62300000,2018,98200000
a simple favor,LGF,53500000,44100000,2018,97600000
the favourite,FoxS,34400000,61600000,2018,96000000
truth or dare,Uni.,41400000,53900000,2018,95300000
i feel pretty,STX,48800000,45700000,2018,94500000
blockers,Uni.,60300000,33700000,2018,94000000
goosebumps 2: haunted halloween,Sony,46700000,46600000,2018,93300000
blackkklansman,Focus,49300000,44000000,2018,93300000
overboard (2018),PNT,50300000,40900000,2018,91200000
sherlock gnomes,Par.,43200000,47100000,2018,90300000
robin hood (2018),LG/S,30800000,54000000,2018,84800000
mortal engines,Uni.,16000000,67700000,2018,83700000
how long will i love u,WGUSA,747000,82100000,2018,82847000
den of thieves,STX,44900000,35600000,2018,80500000
hereditary,A24,44100000,35300000,2018,79400000
tag,WB (NL),54700000,23400000,2018,78100000
vice,Annapurna,47800000,28200000,2018,76000000
widows,Fox,42400000,33600000,2018,76000000
sicario: day of the soldado,Sony,50100000,25800000,2018,75900000
searching,SGem,26000000,49400000,2018,75400000
the spy who dumped me,LGF,33600000,41800000,2018,75400000
second act,STX,39300000,33000000,2018,72300000
sanju,FIP,7900000,63600000,2018,71500000
book club,Par.,68600000,0,2018,68600000
12 strong,WB,45800000,21600000,2018,67400000
"love, simon",Fox,40800000,25500000,2018,66300000
mile 22,STX,36100000,30200000,2018,66300000
life of the party,WB (NL),53100000,12800000,2018,65900000
isle of dogs,FoxS,32000000,32200000,2018,64200000
adrift,STX,31400000,28500000,2018,59900000
the 15:17 to paris,WB,36300000,20800000,2018,57100000
early man,LGF,8300000,46400000,2018,54700000
peppermint,STX,35400000,18400000,2018,53800000
teen titans go! to the movies,WB,29800000,22300000,2018,52100000
slender man,SGem,30600000,21200000,2018,51800000
breaking in (2018),Uni.,46800000,4600000,2018,51400000
once upon a deadpool,Fox,6100000,44400000,2018,50500000
the son of bigfoot,VPD,289000,46800000,2018,47089000
uncle drew,LG/S,42500000,4200000,2018,46700000
tyler perry's acrimony,LGF,43500000,2900000,2018,46400000
mary queen of scots,Focus,16500000,29900000,2018,46400000
the possession of hannah grace,SGem,14800000,28200000,2018,43000000
overlord,Par.,21700000,20000000,2018,41700000
the darkest minds,Fox,12700000,28400000,2018,41100000
holmes and watson,Sony,30600000,9900000,2018,40500000
show dogs,Global Road,17900000,21300000,2018,39200000
on the basis of sex,Focus,24600000,13600000,2018,38200000
namiya,CL,70800,35300000,2018,35370800
the girl in the spider's web: a new dragon tattoo story,Sony,14800000,20300000,2018,35100000
the hate u give,Fox,29700000,5200000,2018,34900000
death wish (2018),MGM,34000000,0,2018,34000000
nobody's fool,Par.,31700000,1800000,2018,33500000
bad times at the el royale,Fox,17800000,14000000,2018,31800000
baaghi 2,FIP,1300000,29900000,2018,31200000
the happytime murders,STX,20700000,6800000,2018,27500000
midnight sun,Global Road,9600000,17800000,2018,27400000
pad man,Sony,1700000,25600000,2018,27300000
monster family,VPD,127000,26300000,2018,26427000
white boy rick,Studio 8,24000000,1900000,2018,25900000
winchester,LGF,25100000,0,2018,25100000
the death of stalin,IFC,8000000,16600000,2018,24600000
strangers: prey at night,Aviron,24600000,0,2018,24600000
"paul, apostle of christ",Affirm,17600000,5500000,2018,23100000
padmaavat,VPD,11800000,11100000,2018,22900000
proud mary,SGem,20900000,876000,2018,21776000
superfly,Sony,20500000,236000,2018,20736000
if beale street could talk,Annapurna,14900000,5700000,2018,20600000
burn the stage: the movie,Trafalgar,4200000,16100000,2018,20300000
detective k: secret of the living dead,WGUSA,104000,18500000,2018,18604000
the wife,SPC,9600000,8600000,2018,18200000
hell fest,LGF,11100000,7100000,2018,18200000
chappaquiddick,ENTMP,17400000,591000,2018,17991000
they shall not grow old,WB,18000000,0,2018,18000000
free solo,NGE,17500000,0,2018,17500000
the children act,A24,548000,17000000,2018,17548000
beautiful boy (2018),Amazon,7600000,8700000,2018,16300000
hunter killer,LG/S,15800000,0,2018,15800000
tully (2018),Focus,9400000,6300000,2018,15700000
unfriended: dark web,BH Tilt,8900000,6300000,2018,15200000
upgrade,BH Tilt,12000000,2400000,2018,14400000
unsane,BST,7700000,6600000,2018,14300000
the sisters brothers,Annapurna,3100000,10000000,2018,13100000
welcome to marwen,Uni.,10800000,2100000,2018,12900000
hotel artemis,Global Road,6700000,6000000,2018,12700000
marrowbone,Magn.,1400,12300000,2018,12301400
102 not out,Sony,1300000,10900000,2018,12200000
boy erased,Focus,6800000,5000000,2018,11800000
back to burgundy,MBox,258000,11400000,2018,11658000
the bookshop,Greenwich,1600000,9900000,2018,11500000
the old man & the gun,FoxS,11300000,0,2018,11300000
gringo,STX,5000000,6000000,2018,11000000
golden slumber,CJ,94500,10600000,2018,10694500
kin,LGF,5700000,4300000,2018,10000000
the big bad fox and other tales,GK,35800,9600000,2018,9635800
traffik,LGF,9200000,336000,2018,9536000
can you ever forgive me?,FoxS,8800000,0,2018,8800000
7 days in entebbe,Focus,3300000,5400000,2018,8700000
pope francis - a man of his word,Focus,2000000,6600000,2018,8600000
condorito: la pelicula,LGF,448000,8000000,2018,8448000
suspiria,Amazon,2500000,5400000,2018,7900000
disobedience,BST,3500000,4400000,2018,7900000
qu√© le√≥n (what a lion),Spanglish,2600000,5200000,2018,7800000
life itself (2018),Amazon,4099999,3700000,2018,7799999
beirut,BST,5000000,2500000,2018,7500000
return of the hero,Distrib.,37100,7300000,2018,7337100
soorma,Sony,390000,6200000,2018,6590000
the hurricane heist,ENTMP,6100000,0,2018,6100000
every day (2018),Orion,6100000,0,2018,6100000
leave no trace,BST,6000000,0,2018,6000000
my hero academia: two heroes,FUN,5800000,0,2018,5800000
destroyer,Annapurna,1500000,4000000,2018,5500000
madame,Blue Fox,91000,5300000,2018,5391000
colette,BST,5100000,0,2018,5100000
blindspotting,LG/S,4300000,530000,2018,4830000
cold war (2018),Amazon,4600000,0,2018,4600000
papillon (2018),BST,2300000,2200000,2018,4500000
gotti,VE,4300000,0,2018,4300000
the mercy,Scre.,29500,4200000,2018,4229500
hichki,Yash,330000,3900000,2018,4230000
ya veremos,PNT,4200000,0,2018,4200000
don't worry he won't get far on foot,Amazon,1400000,2500000,2018,3900000
a private war,Aviron,1600000,2200000,2018,3800000
ben is back,RAtt.,3700000,0,2018,3700000
bad samaritan,Electric,3400000,0,2018,3400000
gauguin: voyage to tahiti,Cohen,200000,3100000,2018,3300000
shoplifters,Magn.,3300000,0,2018,3300000
the front runner,Sony,2000000,1200000,2018,3200000
2001: a space odyssey (2018 re-release),WB,3200000,0,2018,3200000
wildlife,IFC,1100000,2000000,2018,3100000
la boda de valentina,PNT,2800000,0,2018,2800000
you were never really here,Amazon,2500000,0,2018,2500000
billionaire boy's club,VE,1300,2500000,2018,2501300
the rider,SPC,2400000,0,2018,2400000
mary and the witch's flower,GK,2400000,0,2018,2400000
bilal: a new breed of hero,VE,491000,1700000,2018,2191000
a fantastic woman,SPC,2000000,0,2018,2000000
met opera: la traviata,Fathom,1900000,0,2018,1900000
capernaum,SPC,1700000,0,2018,1700000
i still see you,LGF,1400,1500000,2018,1501400
finding your feet,RAtt.,1400000,0,2018,1400000
never look away,SPC,1300000,0,2018,1300000
maria by callas,SPC,1300000,0,2018,1300000
mandy,RLJ,1200000,0,2018,1200000
andhadhun,Eros,1200000,0,2018,1200000
lean on pete,A24,1200000,0,2018,1200000
nothing to lose (2018),Swen,1000000,0,2018,1000000
raid (2018),Eros,1000000,0,2018,1000000
the insult,Cohen,1000000,0,2018,1000000
little italy,EOne,990000,0,2018,990000
the catcher was a spy,IFC,725000,229000,2018,954000
the miseducation of cameron post,FR,905000,0,2018,905000
kedarnath,PackYourBag,901000,0,2018,901000
schindler's list (2018 re-release),Uni.,833000,0,2018,833000
mirai,GK,813000,0,2018,813000
beast,RAtt.,800000,0,2018,800000
pokemon the movie: the power of us,Fathom,789000,0,2018,789000
the party (2017),RAtt.,750000,0,2018,750000
burning,WGUSA,719000,0,2018,719000
foxtrot,SPC,619000,0,2018,619000
the sound of music (2018 re-release),Fathom,616000,0,2018,616000
the big lebowski (20th anniversary),Fathom,583000,0,2018,583000
manmarziyaan,Eros,567000,0,2018,567000
loveless (2018),SPC,566000,0,2018,566000
tommy wiseau's the room,Fathom,550000,0,2018,550000
fireworks (2018),GK,525000,0,2018,525000
the spy gone north,CJ,501000,0,2018,501000
the happy prince,SPC,466000,0,2018,466000
final portrait,SPC,462000,0,2018,462000
bag of marbles,Gaum.,411000,0,2018,411000
vertigo (60th anniversary),Fathom,394000,0,2018,394000
oh lucy!,FM,375000,0,2018,375000
mountain,Greenwich,365000,0,2018,365000
time freak,Grindstone,10000,256000,2018,266000
what they had,BST,260000,0,2018,260000
batti gul meter chalu,Eros,250000,0,2018,250000
borg vs. mcenroe,Neon,231000,0,2018,231000
matangi/maya/m.i.a.,Abr.,231000,0,2018,231000
mazinger z: infinity,Fathom,221000,0,2018,221000
fate/stay night: heaven's feel - i. presage flower,Fathom,194000,0,2018,194000
summer 1993,Osci.,186000,0,2018,186000
maquia: when the promised flower blooms (subtitled),Elev.,186000,0,2018,186000
karwaan,PackYourBag,182000,0,2018,182000
last letter,CL,181000,0,2018,181000
the accidental detective 2: in action,CJ,179000,0,2018,179000
the guardians,MBox,177000,0,2018,177000
luis & the aliens,VPD,170000,0,2018,170000
double lover,Cohen,168000,0,2018,168000
ghost stories,IFC,149000,0,2018,149000
museo,Vita.,149000,0,2018,149000
the little mermaid (2018),Conglomerate,147000,0,2018,147000
the young karl marx,Orch.,126000,0,2018,126000
becoming astrid,MBox,120000,0,2018,120000
ryuichi sakamoto: coda,MUBI,117000,0,2018,117000
gonjiam: haunted asylum,WGUSA,115000,0,2018,115000
take point,CJ,112000,0,2018,112000
the dawn wall,Orch.,112000,0,2018,112000
the negotiation,CJ,111000,0,2018,111000
the captain,MBox,109000,0,2018,109000
mary shelley,IFC,109000,0,2018,109000
in between,FM,108000,0,2018,108000
namaste england,Eros,104000,0,2018,104000
happy phirr bhag jayegi,Eros,103000,0,2018,103000
ismael's ghosts,Magn.,103000,0,2018,103000
revenge (2018),Neon,102000,0,2018,102000
unstoppable (2018),WGUSA,101000,0,2018,101000
reign of judges: title of liberty - concept short,Darin Southa,93200,5200,2018,98400
the third murder,FM,89300,0,2018,89300
the house that jack built,IFC,88000,0,2018,88000
custody,KL,83900,0,2018,83900
godard mon amour,Cohen,82300,0,2018,82300
just a breath away,EOne,78000,0,2018,78000
mukkabaaz,Eros,75900,0,2018,75900
keys to the heart,CJ,75100,0,2018,75100
tehran taboo,KL,74800,0,2018,74800
the last suit,OutF,73500,0,2018,73500
"nico, 1988",Magn.,73300,0,2018,73300
antonio lopez 1970: sex fashion & disco,FM,43200,30000,2018,73200
helicopter eela,Eros,72000,0,2018,72000
under the tree,Magn.,67600,0,2018,67600
before we vanish,Super,52100,0,2018,52100
i am not a witch,FM,50900,0,2018,50900
racer & the jailbird,Super,46300,0,2018,46300
rodin,Cohen,44300,0,2018,44300
what will people say,KL,44200,0,2018,44200
a ciambra,IFC,41900,0,2018,41900
oolong courtyard,CL,37700,0,2018,37700
girls vs gangsters,WGUSA,37100,0,2018,37100
"no date, no signature",Distrib.,36400,0,2018,36400
the apparition (2018),MBox,28300,0,2018,28300
the charmer,FM,26200,0,2018,26200
elliot: the littlest reindeer,Scre.,24300,0,2018,24300
the workshop,Strand,22100,0,2018,22100
loving pablo,Uni.,22000,0,2018,22000
a paris education,KL,21600,0,2018,21600
tag along: the devil fish,CL,20700,0,2018,20700
gabriel and the mountain,Strand,18400,0,2018,18400
marlina the murderer in four acts,Icar.,17800,0,2018,17800
the escape,IFC,14000,0,2018,14000
how victor 'the garlic' took alexey 'the stud' to the nursing home,CARUSEL,13000,0,2018,13000
"lou andreas-salom√©, the audacity to be free",CLS,12900,0,2018,12900
let yourself go,Men.,12200,0,2018,12200
hannah (2018),PDF,11700,0,2018,11700
souvenir,Strand,11400,0,2018,11400
furious (legend of kolovrat),CARUSEL,10000,0,2018,10000
beauty and the dogs,Osci.,8900,0,2018,8900
the quake,Magn.,6200,0,2018,6200
edward ii (2018 re-release),FM,4800,0,2018,4800
el pacto,Sony,2500,0,2018,2500
the swan,Synergetic,2400,0,2018,2400
an actor prepares,Grav.,1700,0,2018,1700
